"GEOID","population_25_years_and_over","population_25_years_and_overless_than_9th_grade","population_25_years_and_over9th_to_12th_grade_no_diploma","population_25_years_and_overhigh_school_graduate_includes_equivalency","population_25_years_and_oversome_college_no_degree","population_25_years_and_overassociates_degree","population_25_years_and_overbachelors_degree","population_25_years_and_overgraduate_or_professional_degree","population_25_years_and_overhigh_school_graduate_or_higher","population_25_years_and_overbachelors_degree_or_higher","SHAPE_Length","SHAPE_Area"
"01001",39614,803,3323,12977,7774,3593,6507,4637,35488,11144,2.05272376240207,0.150257784174001
"01003",161977,3400,11155,44342,35174,15344,33379,19183,147422,52562,4.27752858289337,0.409822387376142
"01005",17995,1336,3042,6600,3689,1321,1212,795,13617,2007,2.56604097803952,0.223257181995248
"01007",16057,988,2137,7052,2886,1081,1276,637,12932,1913,1.88686336815913,0.156525335928997
"01009",40668,2761,3889,14284,8732,4941,3783,2278,34018,6061,2.39278119698724,0.164412705173003
"01011",6877,439,1101,2841,1319,373,560,244,5337,804,2.04550520145972,0.154695900033504
"01013",13384,509,1423,6050,2504,1019,1087,792,11452,1879,1.81832732150028,0.191749035501002
"01015",80263,3448,8419,27783,18585,6354,9159,6515,68396,15674,2.19604291137605,0.154327235387999
"01017",24828,1496,2779,8996,5735,2432,2383,1007,20553,3390,1.71419332556576,0.15058830347848
"01019",18436,1351,2369,6809,3590,1953,1148,1216,14716,2364,1.88609198846482,0.151942390476083
"01021",30534,1859,3710,13113,5426,2293,2413,1720,24965,4133,2.08444398397303,0.174800320227997
"01023",9281,615,1187,3477,1966,949,750,337,7479,1087,2.6844810611742,0.227715445752369
"01025",16269,883,2009,6740,3091,1287,1379,880,13377,2259,3.77705278042915,0.308578214402497
"01027",9969,599,1095,3813,1946,1182,885,449,8275,1334,2.02264495352241,0.151859694011498
"01029",10559,635,1154,3958,2331,751,1288,442,8770,1730,2.17331332294635,0.141307380795561
"01031",36163,1701,3233,10108,8154,4765,5130,3072,31229,8202,1.67857354324529,0.167176656707997
"01033",40390,1519,3814,15244,9193,3407,4484,2729,35057,7213,2.17544771604867,0.158868641612633
"01035",8665,276,801,4200,1536,773,585,494,7588,1079,2.5656139255453,0.209563021688
"01037",8165,262,955,3410,1851,772,639,276,6948,915,1.74153039716632,0.166415724009998
"01039",26421,1206,2709,10037,5432,2861,2509,1667,22506,4176,2.34794117316753,0.255974945721869
"01041",9281,638,1104,3882,1364,769,1070,454,7539,1524,2.27105579259996,0.1505721432565
"01043",60563,2765,6795,19624,14683,6717,6516,3463,51003,9979,2.44098205388496,0.191092068069504
"01045",33606,1493,3600,10376,8448,3411,4218,2060,28513,6278,1.63835682149237,0.138214878241573
"01047",26319,917,2792,10065,5391,2913,2588,1653,22610,4241,3.01744362246916,0.2465401007985
"01049",48286,5226,5296,16172,9659,4964,4233,2736,37764,6969,2.20319822910032,0.197864892232051
"01051",60372,2178,5281,19351,12663,6069,9977,4853,52913,14830,2.2543365237995,0.163460995856004
"01053",25716,1192,3505,11249,4496,2047,2180,1047,21019,3227,2.48678033640025,0.233341798150912
"01055",72558,2828,7186,24491,17762,7224,7916,5151,62544,13067,2.05963507659953,0.138750907781999
"01057",11498,666,1285,4714,2507,965,1004,357,9547,1361,1.83752674226277,0.158561054006503
"01059",21369,1462,2919,9016,3663,1259,2135,915,16988,3050,1.78005193763243,0.164303438329292
"01061",18814,1156,2138,6879,3907,2196,1695,843,15520,2538,1.83336632159684,0.141743049070702
"01063",5534,129,732,2173,1268,529,470,233,4673,703,3.48588347859645,0.164634597420002
"01065",10090,481,1409,3943,1766,898,1095,498,8200,1593,2.47215674143344,0.163554059865995
"01067",12202,841,1439,3931,2244,1114,1755,878,9922,2633,1.61798044653892,0.139768181674032
"01069",73559,2564,6442,23633,17416,7154,10393,5957,64553,16350,2.08676718603965,0.142481495450557
"01071",37709,2148,4479,14431,7124,3455,3744,2328,31082,6072,2.65394338728388,0.287464951013095
"01073",458909,11195,30284,121180,99274,37935,97085,61956,417430,159041,2.89674747270654,0.282678386829496
"01075",9948,613,1132,4151,2129,933,618,372,8203,990,1.64044075585125,0.152723300253899
"01077",64344,1861,5414,22572,13028,5073,10288,6108,57069,16396,2.41870866308418,0.183856187365778
"01079",23333,1277,2635,9642,4418,1793,2275,1293,19421,3568,1.90664573719887,0.182319677131493
"01081",105453,3014,6081,23254,22192,10185,21932,18795,96358,40727,2.02198282301337,0.153222044090333
"01083",71019,3251,6322,19395,15658,6234,13431,6728,61446,20159,1.69244568344909,0.154937338401376
"01085",7171,333,761,3094,1210,690,578,505,6077,1083,2.30663031541937,0.179512789006501
"01087",12539,432,1635,3765,3109,935,1424,1239,10472,2663,2.02202014889147,0.152206105569995
"01089",262659,6051,15033,50364,54540,20348,70676,45647,241575,116323,2.38833506518161,0.207260291539725
"01091",13044,339,1411,4653,2764,1307,1438,1132,11294,2570,2.63518920298358,0.243531180367001
"01093",21005,1211,2710,7472,4601,2362,1553,1096,17084,2649,1.89923572566337,0.188205126548046
"01095",64758,4462,6213,20178,13479,6574,9468,4384,54083,13852,2.20836076075294,0.158176288829001
"01097",280280,8053,25974,95988,59057,24155,43183,23870,246253,67053,3.68085786877512,0.309657660551465
"01099",13867,517,1923,6205,2285,1150,1126,661,11427,1787,2.805840198073,0.254586525199
"01101",152516,5789,12926,39384,31789,11752,29766,21110,133801,50876,2.52627143954897,0.198173807196
"01103",84768,5145,7838,26406,18447,7641,13059,6232,71785,19291,1.80513886859861,0.152209774022499
"01105",5560,312,876,2229,887,205,685,366,4372,1051,2.13794193723531,0.180201798855503
"01107",13940,851,1481,5903,2839,1012,1235,619,11608,1854,2.15645126061849,0.223007430029126
"01109",19399,640,1825,7035,3677,838,3161,2223,16934,5384,2.14028274998639,0.166008688591503
"01111",15409,1005,2034,5304,3012,1554,1411,1089,12370,2500,1.58363167008523,0.146393897277074
"01113",39883,1992,3889,11774,10562,4780,4335,2551,34002,6886,2.09224117869158,0.160480227665654
"01117",151072,3000,6632,29933,31323,12516,44496,23172,141440,67668,2.50628657985466,0.202880277296002
"01115",63434,3054,5819,22302,14659,5870,7829,3901,54561,11730,2.41220910911945,0.164593165474999
"01119",7716,228,754,2588,2085,559,832,670,6734,1502,3.06138444555601,0.227136042611642
"01121",57363,2639,7174,19830,13547,5035,5246,3892,47550,9138,2.72355821100712,0.190805453577499
"01123",29460,1464,3968,9300,6713,2693,3242,2080,24028,5322,2.15446143818016,0.1912397926075
"01125",140600,4064,10499,41868,28575,12508,25405,17681,126037,43086,2.8926443415847,0.338841734102005
"01127",45362,2562,5471,15674,10427,4837,3872,2519,37329,6391,2.3811515772666,0.203015138449999
"01129",10831,452,1046,4606,2311,947,643,826,9333,1469,2.62832623065593,0.267440033151637
"01131",7154,392,1093,2806,1611,467,522,263,5669,785,2.65040484245363,0.224243860512
"01133",17016,1004,2516,6590,3340,1276,1269,1021,13496,2290,1.67985533459205,0.160031763545501
"02013",2598,158,239,1080,568,139,275,139,2201,414,52.5312845488122,2.62376780662589
"02016",3838,185,159,1664,962,223,554,91,3494,645,55.669207828762,1.56506491348419
"02020",193312,4236,7063,45842,48371,16715,44110,26975,182013,71085,4.74867969487413,0.748446820891179
"02050",10025,689,1119,4674,1811,456,729,547,8217,1276,45.6776033596975,18.185811366681
"02060",643,19,15,194,217,56,108,34,609,142,2.39252257684435,0.205684341417412
"02063",4908,44,181,1145,1489,540,933,576,4683,1509,64.5987050177879,4.25867628025461
"02066",1845,38,71,650,446,91,338,211,1736,549,20.4593016391854,11.1188146328436
"02068",1656,7,20,504,346,126,409,244,1629,653,15.2401885073044,5.94630229323851
"02070",2883,155,233,1151,613,167,293,271,2495,564,20.0170111177522,7.86136451269161
"02090",61343,1143,2250,15698,16505,5771,11586,8390,57950,19976,13.2746560507643,3.63515424261301
"02100",1431,7,26,564,452,15,168,199,1398,367,11.7560151448592,0.977115515932635
"02105",1902,16,103,694,474,190,333,92,1783,425,38.1383398288403,2.72216951623376
"02110",22827,266,783,4791,5823,2019,5924,3221,21778,9145,10.1318703288228,1.12114820304525
"02122",41278,682,1815,12743,11199,3543,7251,4045,38781,11296,47.8615384278958,6.89946863754132
"02130",9801,131,460,2829,3076,719,1751,835,9210,2586,21.1238640288382,1.90598004248194
"02150",8907,455,392,2508,2115,838,1673,926,8060,2599,47.5010220795635,2.77958772199562
"02158",4075,189,644,2266,764,93,93,26,3242,119,20.9220967814914,8.06260739802986
"02164",634,29,39,258,125,42,69,72,566,141,38.5518218717489,10.600215285493
"02170",69796,1288,3096,23039,18611,7210,10889,5663,65412,16552,17.3669587941016,11.1976509746017
"02180",5622,204,491,2451,1278,165,427,606,4927,1033,43.8381952118662,11.6397878358614
"02185",7007,222,643,2904,1652,493,760,333,6142,1093,71.1801400957723,53.1131131238008
"02188",4290,203,470,2020,798,180,305,314,3617,619,44.2357864843879,19.6243826423391
"02195",2538,99,117,788,587,226,562,159,2322,721,12.726502000852,1.17778555261307
"02198",4172,56,263,1588,1102,362,568,233,3853,801,45.4331987259944,2.18900111500261
"02220",6088,158,158,1546,1578,624,1343,681,5772,2024,20.2068043837079,1.23468549181115
"02230",1062,68,33,356,284,55,199,67,961,266,2.26608447124171,0.179342033123337
"02240",4471,103,229,1704,1127,443,540,325,4139,865,21.9753656897978,11.8763441656331
"02275",1563,24,214,578,392,118,175,62,1325,237,16.5288189121552,1.007858476656
"02282",388,4,17,173,133,21,33,7,367,40,19.0639844631521,3.29594411726661
"02290",3479,167,281,1471,943,168,293,156,3031,449,63.6232284666296,74.2568919925616
"04001",42362,3412,4137,13150,12661,3568,3265,2169,34813,5434,9.28924863999137,2.88337291378615
"04003",87435,4091,5806,21308,23931,9730,13908,8661,77538,22569,5.02015909591142,1.5351877522607
"04005",86198,2859,4927,18341,19632,7046,19762,13631,78412,33393,12.3414771389465,4.82178404787192
"04007",39292,1100,4031,11192,11861,3726,4613,2769,34161,7382,8.15054709307096,1.20914271793499
"04009",24046,1057,2923,7123,6746,2668,2399,1130,20066,3529,5.42121454883853,1.15872891993499
"04011",5762,226,484,1877,1807,446,750,172,5052,922,3.42762965052363,0.463092458554208
"04012",13182,769,1341,4476,3826,1212,1022,536,11072,1558,5.7501590278353,1.13657789624266
"04013",2928408,148240,178497,644940,689293,261342,631052,375044,2601671,1006096,8.07764772004256,2.31437179159702
"04015",162829,5929,14508,55859,48067,14649,14549,9268,142392,23817,10.5732906635543,3.47234334778966
"04017",69674,3736,7030,20551,20513,6233,6881,4730,58908,11611,8.74475724197285,2.55966156517566
"04019",699288,28678,45790,149641,172153,62649,137833,102544,624820,240377,7.43605298269574,2.27404149983225
"04021",293016,12770,23641,89200,76521,29667,40942,20275,256605,61217,5.92103183530592,1.34167726517099
"04023",30361,3086,3671,7913,6266,2431,4257,2737,23604,6994,2.54895153101504,0.304358321068515
"04025",180855,3939,11341,45486,52902,16956,29164,21067,165575,50231,7.36273312783317,2.06866898679951
"04027",129299,16595,15846,34441,31450,10681,12942,7344,96858,20286,5.53643944920616,1.37603812732514
"05001",11988,668,928,5020,1962,1423,1340,647,10392,1987,3.32878751923832,0.2633871329275
"05003",13411,768,1220,6823,2193,795,1223,389,11423,1612,2.37834809439828,0.235522747491444
"05005",31668,926,2667,10992,7771,3420,4008,1884,28075,5892,2.13585801601888,0.152462700093371
"05007",182880,9003,9808,53695,35039,12124,41442,21769,164069,63211,2.61894554120617,0.229885817671011
"05009",26166,999,1850,8849,7054,2766,3125,1523,23317,4648,1.69726877494972,0.156453018193764
"05011",7251,409,742,3111,1575,506,644,264,6100,908,2.39723035822197,0.164000066196999
"05013",3438,87,456,1490,681,303,256,165,2895,421,2.38864250485548,0.159023799289
"05015",19931,1594,1354,7009,4208,1377,2892,1497,16983,4389,2.1218004170533,0.165970796725187
"05017",7114,511,1026,2725,1443,359,737,313,5577,1050,2.74913295912285,0.173275444304626
"05019",12605,367,826,4037,3196,663,2338,1178,11412,3516,2.98642490318637,0.223332663249004
"05021",10347,641,984,4430,2029,815,849,599,8722,1448,2.28390341201212,0.166971325226427
"05023",18514,840,1336,7850,3704,1640,2005,1139,16338,3144,1.60766036197021,0.152425645232501
"05025",5531,67,447,2584,1216,293,607,317,5017,924,1.8469557478306,0.151174182737503
"05027",14051,543,1281,5590,2866,939,1881,951,12227,2832,1.85824287732468,0.192116976739327
"05029",14381,640,1066,5896,2790,1303,2009,677,12675,2686,2.09679931873525,0.145314937511
"05031",70517,3264,4028,23151,14021,5641,12635,7777,63225,20412,2.10767151976442,0.184086456740748
"05033",40859,1802,4359,13947,9198,3761,5541,2251,34698,7792,2.19828146390591,0.1560519240267
"05035",30865,1583,3201,10940,7253,2496,3690,1702,26081,5392,2.49023657804348,0.16517523727354
"05037",11747,789,1349,4907,2222,829,1004,647,9609,1651,1.6899958801427,0.159662657347497
"05039",4660,174,397,2108,1094,351,395,141,4089,536,2.4364016645337,0.168732206196997
"05041",7728,721,756,3415,1487,292,746,311,6251,1057,3.92186355133433,0.204907116758018
"05043",11170,462,994,4090,2289,683,1703,949,9714,2652,1.94371520347496,0.210267931039497
"05045",76466,1863,3405,23020,17072,5951,15682,9473,71198,25155,2.16783938859911,0.1701259841315
"05047",11803,662,934,4911,2863,1182,914,337,10207,1251,2.14670362637211,0.159594309558499
"05049",8678,367,857,3229,2568,668,584,405,7454,989,1.89309887664602,0.161383355596929
"05051",72278,1885,5070,23014,18195,6936,11173,6005,65323,17178,2.00730591409957,0.186853800657993
"05053",12554,272,783,5351,2969,924,1648,607,11499,2255,1.86794496561951,0.160523374442494
"05055",30735,944,2541,13628,6570,2048,3283,1721,27250,5004,1.98453079703696,0.150067146291371
"05057",13491,1019,1162,5182,2811,1158,1342,817,11310,2159,2.45095770079593,0.186727585259004
"05059",23602,629,2070,9240,5832,1951,2624,1256,20903,3880,2.23505526172,0.157860598477503
"05061",8604,334,694,3596,1957,796,822,405,7576,1227,2.35349094425591,0.1507183454575
"05063",25394,1119,2491,9405,6079,2122,2906,1272,21784,4178,2.3288090875991,0.199109813994003
"05065",10270,655,1183,3414,2471,799,1229,519,8432,1748,1.90117509035167,0.151344890087498
"05067",11987,604,1376,5169,2435,884,905,614,10007,1519,2.40695741492412,0.165233510969379
"05069",46411,1571,3812,19219,10365,2414,6200,2830,41028,9030,2.83771187802225,0.232302168584
"05071",16953,1552,1825,6929,3143,788,1751,965,13576,2716,2.07274476420481,0.176195350596998
"05073",4566,368,496,2095,913,204,381,109,3702,490,2.37136790414014,0.136834602900606
"05075",10968,546,1122,4271,2644,754,1148,483,9300,1631,2.09297156183594,0.1534099538415
"05077",6248,366,775,2847,1296,354,519,91,5107,610,2.56963861640304,0.158711158397301
"05079",9871,630,1225,4753,1949,452,609,253,8016,862,2.0010180208692,0.143909546204505
"05081",8378,181,666,3656,1936,693,857,389,7531,1246,3.11855605824548,0.141894946691858
"05083",15100,579,1274,6704,3432,1203,1260,648,13247,1908,2.64175007481343,0.187134675693494
"05085",49256,1689,3266,18597,10357,5332,6796,3219,44301,10015,2.34056313679333,0.204834352331996
"05087",11492,663,1071,5735,1960,507,994,562,9758,1556,2.1299297238372,0.216688651912499
"05089",12801,553,1217,4682,3311,1105,1296,637,11031,1933,2.15272681454403,0.166298042259705
"05091",29215,1243,2585,10586,7815,2036,3010,1940,25387,4950,2.70791326123407,0.160089604368725
"05093",26769,1722,2932,11058,5282,1962,2517,1296,22115,3813,3.03990090817961,0.239962616255812
"05095",4861,379,651,2007,901,268,463,192,3831,655,2.402600196276,0.158277463896002
"05097",6421,318,712,2111,1729,566,701,284,5391,985,1.87305133488094,0.203557328073
"05099",5724,222,295,2937,1166,467,479,158,5207,637,1.94300151548892,0.156246425854496
"05101",5345,247,543,2026,1280,372,598,279,4555,877,2.01030158446503,0.212940863289508
"05103",16039,489,1506,6501,4269,1143,1350,781,14044,2131,2.74266606649063,0.186125828496505
"05105",7090,245,372,3076,1727,429,893,348,6473,1241,2.40529475592324,0.143346022851502
"05107",10976,779,1231,3489,2770,1132,1070,505,8966,1575,2.823791085747,0.184829666481054
"05109",7146,479,386,2729,1674,486,897,495,6281,1392,2.23296580450089,0.155595433276998
"05111",15775,1433,1487,7067,3323,649,1318,498,12855,1816,2.04100578724851,0.196704754490005
"05113",13607,505,1064,5178,3646,1102,1322,790,12038,2112,2.15427214855906,0.218996123206657
"05115",40886,2344,4098,13836,8388,2718,6480,3022,34444,9502,2.10821489529283,0.213641285489998
"05117",6025,255,538,2552,1306,453,614,307,5232,921,2.61954640095054,0.172416223932004
"05119",270836,8215,14868,69538,58689,21094,58292,40140,247753,98432,2.82719107175176,0.205904737310008
"05121",12635,826,995,4839,2795,1150,1311,719,10814,2030,2.21332688793008,0.170546925735477
"05125",84850,2294,4658,26015,20179,8019,16275,7410,77898,23685,2.62651671334867,0.186030939136498
"05127",6921,536,851,2827,1436,514,562,195,5534,757,2.38747049793813,0.229387008633247
"05129",5769,487,658,2282,1041,417,635,249,4624,884,1.86083381636103,0.172858932077496
"05131",85679,5282,7932,25325,20426,6155,13072,7487,72465,20559,2.10286899435539,0.139539767353085
"05133",10057,1328,1334,3474,1917,835,775,394,7395,1169,2.44741755689258,0.146882086587173
"05135",12494,645,1575,4873,3196,814,973,418,10274,1391,2.16156315860689,0.157312848726774
"05123",16685,955,1995,6559,3856,1417,1085,818,13735,1903,2.0723046266718,0.164348347126499
"05137",9069,413,981,3128,2181,1062,974,330,7675,1304,2.09257869890064,0.1575527347225
"05139",26804,1032,2632,10177,5694,2338,3306,1625,23140,4931,3.0037304528903,0.264302117989943
"05141",11740,584,1170,4857,2342,877,1160,750,9986,1910,2.0499018831617,0.186457212711498
"05143",148635,10289,9781,40952,28566,8887,29512,20648,128565,50160,2.28829522415545,0.246464490391704
"05145",50133,2241,4885,20258,8472,4103,6116,4058,43007,10174,3.32939987087495,0.267306486759612
"05147",4471,246,539,1929,669,368,402,318,3686,720,2.59879603123535,0.152285972778502
"05149",13905,1249,1886,5240,2739,838,1372,581,10770,1953,2.8387838817079,0.242495383113499
"06001",1193863,68311,62961,198825,194409,76687,337847,254823,1062591,592670,2.75676915029011,0.198462609458208
"06003",969,34,27,249,235,43,200,181,908,381,2.15712128406384,0.199005750264005
"06005",31725,764,1993,9724,8752,4300,4317,1875,28968,6192,2.87493706367099,0.161965803431994
"06007",142167,4840,8894,31704,39391,15029,27819,14490,128433,42309,4.17546061944211,0.455938122447996
"06009",34951,799,2415,10815,10250,3713,4876,2083,31737,6959,2.93105787147134,0.276243186277493
"06011",13942,2348,1371,4246,2594,1340,1558,485,10223,2043,3.17151912466479,0.312217210522998
"06013",805020,42474,40090,140633,160404,66758,218293,136368,722456,354661,2.71043049163387,0.20187090134458
"06015",19703,999,2826,6101,4942,1659,2070,1106,15878,3176,2.94621140236635,0.284584687205044
"06017",139444,2557,4864,28993,35646,16021,34494,16869,132023,51363,3.75275834798292,0.479632322832659
"06019",619376,76606,60229,140532,145859,55967,93209,46974,482541,140183,8.91453002178456,1.57116975291051
"06021",18294,2613,1690,5538,4221,1507,2226,499,13991,2725,3.2873158109115,0.360058462750499
"06023",93815,2529,5922,21654,24929,9518,19376,9887,85364,29263,4.97274373277289,0.996458004682815
"06025",110267,16255,16340,28187,25791,6936,12239,4519,77672,16758,5.03088344924037,1.12036276751584
"06027",13746,433,655,4188,3471,1250,2217,1532,12658,3749,8.83374311311885,2.66523022406187
"06029",552243,71745,61081,152266,126244,43671,63839,33397,419417,97236,7.27969662483015,2.09671366879899
"06031",94259,13052,11804,24622,22753,8530,9159,4339,69403,13498,2.87336189428106,0.360718193711497
"06033",48848,2515,4033,14601,13272,5870,5747,2810,42300,8557,3.65457886850753,0.358522273631503
"06035",24323,1317,3536,7891,6566,2150,2098,765,19470,2863,5.97268525297054,1.30222957672754
"06037",6922061,813149,568298,1411475,1285626,486941,1530075,826497,5540614,2356572,6.6577948495007,1.03984722294684
"06039",98573,16258,11531,22929,24341,7370,11366,4778,70784,16144,4.82466134383999,0.566042630318
"06041",192700,7844,4828,19589,31731,12801,65270,50637,180028,115907,2.48321945665608,0.144594816610685
"06043",13513,460,773,3028,3939,1412,2624,1277,12280,3901,3.41161667834808,0.386530155528499
"06045",65151,4196,4508,17147,17770,5568,9612,6350,56447,15962,5.60955338982974,0.952376019006195
"06047",165461,28922,20132,43880,36243,13025,15979,7280,116407,23259,3.53936655443071,0.520115606844491
"06049",6564,464,491,2136,1607,573,864,429,5609,1293,4.53914624448648,1.17554802744456
"06051",9497,593,621,2124,2375,980,1833,971,8283,2804,5.6513948373702,0.831215458205641
"06053",280524,50976,24795,56912,50847,22683,44514,29797,204753,74311,6.04246960192522,0.86004365142774
"06055",98545,9017,5524,17698,20920,8922,24141,12323,84004,36464,2.75908870184226,0.210922715261002
"06057",78580,1309,2518,14963,21288,8111,19385,11006,74753,30391,3.51700285936364,0.263294414278884
"06059",2197190,159612,134568,378888,428349,170409,585008,340356,1903010,925364,2.07136286872895,0.201082354417989
"06061",281849,5588,8996,49539,69403,31072,76411,40840,267265,117251,4.31906868313435,0.404901141606127
"06063",15047,205,615,4108,5008,1647,2233,1231,14227,3464,5.25029566634099,0.713899002361
"06065",1572798,142125,125400,423504,378894,132743,238066,132066,1305273,370132,7.94365603846877,1.84019783195902
"06067",1067929,66453,61002,235075,259949,103745,221577,120128,940474,341705,3.24221886656303,0.265780033134002
"06069",41203,4329,2572,11037,10594,4211,6305,2155,34302,8460,3.6253164906807,0.362726754042505
"06071",1377666,113848,146467,370115,327584,117761,197308,104583,1117351,301891,10.4430910033238,5.13221118043237
"06073",2251321,140183,122880,409660,483335,188808,552537,353918,1988258,906455,4.64369820739172,1.06434767030861
"06075",688969,46904,30396,78359,87355,35903,243795,166257,611669,410052,0.644615119938623,0.0125710736739478
"06077",488393,53581,42635,140468,110472,46154,64170,30913,392177,95083,3.22763015643651,0.378682532957507
"06079",190323,6410,8944,37215,48533,19301,43001,26919,174969,69920,5.89215022437366,0.85364787178542
"06081",551707,28749,21903,82159,90968,38527,162209,127192,501055,289401,2.10647871262286,0.120736644798594
"06083",277880,32126,18148,47957,58882,23131,58791,38845,227606,97636,6.33058850547556,0.700450795299572
"06085",1349372,84521,61383,184860,193313,91345,375482,358468,1203468,733950,3.45422425338198,0.341945349905223
"06087",179985,14098,7004,28627,39428,15430,43339,32059,158883,75398,2.2234454554382,0.117241538670341
"06089",128609,3096,8396,33218,39786,15072,19506,9535,117117,29041,5.64068621028592,1.06276037354302
"06091",2307,43,87,681,755,226,259,256,2177,515,3.01783335529646,0.261252394189561
"06093",32223,1224,2026,8724,9387,3929,4595,2338,28973,6933,7.25152416541195,1.77548565079717
"06095",312459,17302,17535,74274,83824,32543,58967,28014,277622,86981,2.73454615998781,0.23732651249173
"06097",356445,20831,17788,65278,86331,33872,82579,49766,317826,132345,3.74935422365712,0.425280212206898
"06099",348982,37681,32279,104577,85846,26010,42993,19596,279022,62589,3.79711375805744,0.399827557298003
"06101",64872,6899,6303,15907,16083,6709,8650,4321,51670,12971,2.74986823862067,0.163944723157006
"06103",44894,2891,3498,13014,13056,4808,5587,2040,38505,7627,5.08625424989571,0.811000499681002
"06105",12493,215,549,4800,3756,849,1443,881,11729,2324,6.18418884799026,0.884554505982
"06107",278465,47440,28809,73748,61604,24532,28347,13985,202216,42332,5.34656690407505,1.25610678189651
"06109",42285,710,2634,10658,13229,4658,6817,3579,38941,10396,5.00754085260352,0.604462854748499
"06111",574785,49030,33595,113615,124158,58776,124047,71564,492160,195611,3.50945884423023,0.471564716773928
"06113",127688,8648,7184,22654,25117,9086,28159,26840,111856,54999,3.34120559301969,0.274401184980499
"06115",50807,4243,5325,11785,15163,5273,5955,3063,41239,9018,2.80341885263636,0.174093414377
"08001",334333,22623,27981,94610,71102,29657,60392,27968,283729,88360,4.30622901608046,0.322753327060504
"08003",9814,708,573,2790,2350,877,1508,1008,8533,2516,1.83078755410151,0.191028221255501
"08005",446320,16179,19217,87772,86946,37633,124297,74276,410924,198573,3.66910141700734,0.218920249857016
"08007",10195,137,471,2228,2721,567,2650,1421,9587,4071,2.77702552593876,0.356115980485002
"08009",2545,125,243,735,547,290,454,151,2177,605,3.38126867518532,0.673411155221784
"08011",4537,142,444,2203,786,317,381,264,3951,645,2.57053121195945,0.409224197421003
"08013",219430,4323,5579,24354,32821,14414,75764,62175,209528,137939,2.36093267715784,0.2025521030635
"08014",50886,580,1158,6603,8506,4641,18252,11146,49148,29398,1.15093774282716,0.00916585576700281
"08015",15292,244,611,3939,3344,1129,3618,2407,14437,6025,3.09165941273552,0.272445226912498
"08017",1148,23,57,344,335,134,181,74,1068,255,3.10992432302805,0.478855899961281
"08019",7579,90,111,1517,1350,451,2182,1878,7378,4060,1.70576847922748,0.107714754685003
"08021",4981,228,297,1633,1176,428,802,417,4456,1219,2.77718246364933,0.339403687978957
"08023",2603,177,165,762,677,188,398,236,2261,634,2.60696608922599,0.323832788215267
"08025",4210,99,363,2166,783,410,262,127,3748,389,1.95339489257329,0.213317964441494
"08027",3678,26,37,661,1202,330,878,544,3615,1422,2.34854559757074,0.196812551247494
"08029",22937,728,1648,8368,5312,1626,3449,1806,20561,5255,2.73748514590653,0.308733647519999
"08031",514105,25311,25933,82175,82068,28584,164516,105518,462861,270034,2.66958079491314,0.0421163771374988
"08033",1961,0,70,831,413,128,319,200,1891,519,3.15141778136833,0.282660430870148
"08035",235928,2084,2928,28669,44413,18060,90110,49664,230916,139774,2.22335151181592,0.228046192103999
"08037",39773,1892,1407,6210,6065,3947,14080,6172,36474,20252,3.14110482685435,0.459838614036994
"08041",471764,9677,16508,92459,115012,51732,113505,72871,445579,186376,3.25811479450725,0.572143440996
"08039",18546,283,394,4341,4683,2299,4661,1885,17869,6546,3.29517003131116,0.500407936144994
"08043",37938,1002,2914,15356,8429,3178,4620,2439,34022,7059,3.07858701535977,0.410290687574504
"08045",40937,2284,1974,10536,8811,3851,8852,4629,36679,13481,5.50677650878643,0.802609836972648
"08047",4676,23,270,664,920,516,1143,1140,4383,2283,0.963060971977996,0.0410008273129999
"08049",11869,263,396,3591,2357,787,2864,1611,11210,4475,4.07635006051966,0.511407839289002
"08051",10922,69,154,1826,2011,666,4418,1778,10699,6196,5.31561194084138,0.87395699082901
"08053",744,0,27,120,213,36,223,125,717,348,2.8245102770991,0.297770999274519
"08055",5113,209,195,1335,1544,535,840,455,4709,1295,3.83206993821745,0.421484188299002
"08057",1079,45,105,253,314,68,181,113,929,294,3.71140071766585,0.447139032414139
"08059",422743,6064,14485,82874,83851,32951,127924,74594,402194,202518,2.81044410167889,0.210195388790499
"08061",931,11,16,252,329,134,126,63,904,189,3.614617725684,0.476984293856666
"08063",4787,220,297,1392,1413,594,543,328,4270,871,3.2844521121518,0.58461335575409
"08067",40021,394,969,8171,8643,3048,12123,6673,38658,18796,3.0056664938753,0.447325176432726
"08065",5367,434,195,1288,1045,474,1217,714,4738,1931,1.70703691938877,0.103603165214999
"08069",236137,3030,5650,41169,48081,21600,69774,46833,227457,116607,3.8755655816862,0.726361198710556
"08071",10655,551,708,2830,3140,1429,1252,745,9396,1997,5.52547785304947,1.2569527949131
"08073",4207,76,398,2083,619,328,544,159,3733,703,3.89938650289044,0.696392714139497
"08075",15185,325,977,5851,3076,1878,1861,1217,13883,3078,2.98464454955808,0.509331456335218
"08077",107982,2052,7074,29507,28250,9457,20923,10719,98856,31642,5.01896436185874,0.90011940454351
"08079",670,2,12,89,146,44,271,106,656,377,2.040319020326,0.232203891058999
"08081",8940,127,590,3748,1805,986,1172,512,8223,1684,5.03172104177828,1.30950467816041
"08083",18556,445,1248,5553,4207,1536,3341,2226,16863,5567,3.27511714510532,0.537401396963681
"08085",30333,1627,1775,9615,7182,2107,5324,2703,26931,8027,4.58867780751828,0.598979678315026
"08087",18669,1905,1695,5826,4346,1627,2266,1004,15069,3270,2.41367437493475,0.354773764545509
"08089",12658,464,1075,4040,2871,1807,1427,974,11119,2401,2.65062234002256,0.337069567032491
"08091",3986,8,47,542,1166,380,1131,712,3931,1843,2.19984683015342,0.144339477264999
"08093",13890,106,247,3502,3907,1532,3200,1396,13537,4596,3.76899160659497,0.596401338563492
"08095",2850,144,233,800,605,326,490,252,2473,742,1.84757944585912,0.189556396256829
"08097",13447,125,210,1831,1647,1250,5366,3018,13112,8384,2.96665670685545,0.26286862009
"08099",7706,748,626,2255,1947,829,718,583,6332,1301,2.65851369318561,0.436580966804338
"08101",115034,3999,6892,33834,29629,13465,17819,9396,104143,27215,3.43050169133525,0.638829880878508
"08103",4313,86,282,1420,1062,434,699,330,3945,1029,5.18021588239928,0.880027869508313
"08105",7980,463,408,2331,1895,577,1622,684,7109,2306,2.20970764142875,0.241052155366505
"08107",18695,269,353,3035,3816,1724,6218,3280,18073,9498,4.08071029771564,0.651542378904315
"08109",4760,297,338,1460,1035,418,619,593,4125,1212,4.37071803035147,0.84303452975849
"08111",555,19,0,166,106,30,159,75,536,234,1.68991655342125,0.102824157739493
"08113",6242,21,86,1078,1002,314,2730,1011,6135,3741,3.42792589413424,0.342290909756985
"08115",1749,64,133,460,420,280,261,131,1552,392,1.70762661134394,0.151974393634703
"08117",24192,438,882,4207,4864,1024,8436,4341,22872,12777,2.57076776242072,0.168286031705002
"08119",19177,42,372,4782,4931,1961,4015,3074,18763,7089,1.82017474410316,0.150278820208501
"08121",3379,90,200,1052,904,386,493,254,3089,747,3.59484257530236,0.689035717306999
"08123",208860,12040,12838,53024,49613,19776,40238,21331,183982,61569,5.09132322888017,1.10626350241302
"08125",6541,464,355,1858,1651,675,921,617,5722,1538,3.24269247733541,0.647090634007002
"09001",654962,34610,29615,136454,91887,40067,177060,145269,590737,322329,2.8594835208076,0.18172968233892
"09003",628684,26534,34412,162392,106152,52600,137915,108679,567738,246594,2.62217700232809,0.210605837478215
"09005",137919,2739,5687,40662,26256,12669,29273,20633,129493,49906,2.40339675594583,0.264996527333289
"09007",121357,2073,4011,30523,20366,11447,29559,23378,115273,52937,1.8097386031312,0.107653062857538
"09009",604512,26086,32410,178934,101253,44293,117422,104114,546016,221536,2.93222658399373,0.173025662439727
"09011",189965,4736,8487,54331,39861,16907,35980,29663,176742,65643,2.48818587866121,0.19484358439996
"09013",95783,1830,3129,25023,15870,8917,23004,18010,90824,41014,1.85339369848239,0.117123101859024
"09015",81955,2853,5809,28630,16569,8087,11354,8653,73293,20007,1.77397552587515,0.146319536954599
"10001",120839,4736,8776,39620,26194,10474,18796,12243,107327,31039,1.88689377739825,0.161046379166792
"10003",393349,11359,18639,115392,70497,29768,84671,63023,363351,147694,1.92033425884457,0.118063211746901
"10005",176430,6155,12123,54916,32985,16610,30785,22856,158152,53641,2.24320377373205,0.262268560494319
"11001",487726,15816,22118,75562,60253,14508,124285,175184,449792,299469,0.645734240135637,0.0183735483130212
"12001",169822,3820,7763,34518,27591,19410,39331,37389,158239,76720,2.53212895025649,0.233862993555
"12003",18947,653,2034,8294,3655,1433,1743,1135,16260,2878,1.71337929921218,0.14303268881979
"12005",129219,4316,8504,36401,31845,15080,21211,11862,116399,33073,2.25085945829759,0.214263724874445
"12007",20339,1221,2444,8435,4476,1367,1476,920,16674,2396,1.54859270540418,0.0727452061604949
"12009",448084,9826,23822,118401,97562,56522,87283,54668,414436,141951,3.01173759443799,0.308530415943632
"12011",1374668,59255,78645,368968,261596,134914,291484,179806,1236768,471290,2.33965189496626,0.286414427632663
"12013",10150,818,1449,4279,1945,642,757,260,7883,1017,1.87305386027706,0.139598640699494
"12015",153715,3895,8782,51705,36935,14748,23870,13780,141038,37650,2.56061808346894,0.175697964990114
"12017",121075,3278,8953,46072,27932,11362,14448,9030,108844,23478,2.10404856251965,0.158146401487608
"12019",149019,3272,8771,42300,36995,17747,27188,12746,136976,39934,1.77520914207003,0.155786939226005
"12021",285066,16308,13693,74930,48194,23952,63928,44061,255065,107989,3.37890552639597,0.49178723584399
"12023",47698,1748,4703,17405,12036,4458,5058,2290,41247,7348,2.59534354356997,0.19447675677863
"12027",24651,3113,3102,10331,3631,1333,2178,963,18436,3141,1.60378069332228,0.150734356906999
"12029",12472,719,1663,5967,1976,794,742,611,10090,1353,2.17940337196654,0.173687490055427
"12031",674424,20229,43844,189218,142643,66001,141783,70706,610351,212489,2.36202726580839,0.206394551678849
"12033",215669,5402,14872,58926,51828,25576,37553,21512,195395,59065,3.73046556168151,0.181863603610718
"12035",87717,2574,4162,28142,20175,8787,15631,8246,80981,23877,1.56658742805413,0.12224242185947
"12037",9598,689,1337,3071,1789,686,1174,852,7572,2026,4.13400649729701,0.137174599390406
"12039",31151,1971,4016,11085,6066,1907,3986,2120,25164,6106,2.02559571400825,0.128742523596113
"12041",12359,534,1158,5203,2539,1377,1164,384,10667,1548,1.41869045539024,0.0857743520795019
"12043",9687,1285,1677,3203,1914,308,923,377,6725,1300,2.27728031010896,0.232432349471005
"12045",11839,496,1074,3889,2660,991,1728,1001,10269,2729,2.42361748588928,0.138095073715101
"12047",10398,786,1718,4752,1468,733,715,226,7894,941,2.26060514807456,0.126275315879899
"12049",16583,1965,1975,7693,2373,879,1193,505,12643,1698,1.60026580603483,0.150955137525003
"12051",25071,4017,3675,8913,4034,2307,1458,667,17379,2125,2.7515624884369,0.279023328452996
"12053",143751,4600,11230,48346,36893,14788,18536,9358,127921,27894,1.93192186646365,0.118772313073608
"12055",77936,4122,6861,28122,17201,6990,9528,5112,66953,14640,2.83485017937972,0.26131307595
"12057",994683,46388,61201,262090,177680,93867,224209,129248,887094,353457,3.07103298722539,0.257454424017744
"12059",14291,670,2119,6541,2799,798,945,419,11502,1364,1.75010641353643,0.119470881499915
"12061",122616,3447,7428,33926,25641,12925,23763,15486,111741,39249,1.61230697510167,0.128012335548254
"12063",35131,1435,4413,14007,7913,2722,2735,1906,29283,4641,2.22527849445681,0.233020390967905
"12065",10775,528,1217,3738,2214,758,1561,759,9030,2320,2.18645320590685,0.149038093205191
"12067",5978,792,785,2549,1122,293,345,92,4401,437,1.8682885969954,0.132644703182499
"12069",278005,7525,19218,87063,61212,32781,44593,25613,251262,70206,3.1104945965748,0.276731354848497
"12071",568166,24812,33327,175221,116360,53641,100887,63918,510027,164805,3.39561670646266,0.208390812864557
"12073",174434,3618,8246,33154,31361,15977,46511,35567,162570,82078,2.4211461879554,0.170724682687999
"12075",31164,1170,2707,13196,5917,3466,3262,1446,27287,4708,3.00363390815574,0.278323663978514
"12077",5752,303,1020,2383,954,318,478,296,4429,774,2.98837905300553,0.204624830121499
"12079",13461,705,1924,4958,2664,1448,1189,573,10832,1762,2.1563471554892,0.174126344765154
"12081",297254,10581,18374,86428,59193,26945,58131,37602,268299,95733,2.24108910657397,0.188158685821159
"12083",275914,9835,22218,98785,59414,26488,38029,21145,243861,59174,3.32752264424015,0.399542128955997
"12085",122738,3568,6124,31120,28640,11259,26928,15099,113046,42027,2.0358797311421,0.159839714176909
"12086",1917165,166277,169424,506656,280011,186127,380441,228229,1581464,608670,4.59473084303705,0.470052329327689
"12087",64452,2268,2845,17890,13336,5112,13970,9031,59339,23001,9.80501329369002,0.317802070755592
"12089",65419,1516,4047,20197,12915,5948,13383,7413,59856,20796,2.75993290095724,0.163323421696896
"12091",143586,3736,6486,35339,33902,16430,29743,17950,133364,47693,2.02835993315249,0.242547762459981
"12093",28161,2027,3430,10324,5467,2229,3196,1488,22704,4684,2.58482244873482,0.210648819955505
"12095",954106,40159,60336,231759,171937,109275,219794,120846,853611,340640,2.6984047026343,0.239530225517001
"12097",252003,14290,19453,74371,54996,27630,41508,19755,218260,61263,3.34396267269915,0.358073262159495
"12099",1087027,60070,58779,254306,200564,100451,250300,162557,968178,412857,2.95489702062956,0.522739796736443
"12101",399964,11670,26589,133623,84206,39576,67728,36572,361705,104300,2.19204177609144,0.183246193962088
"12103",741415,19207,39018,197083,157501,75675,163138,89793,683190,252931,2.2851693431671,0.0778978190221161
"12105",494853,26963,40548,167752,107460,48182,69222,34726,427342,103948,3.71321179593226,0.477478841796502
"12107",52347,2663,6832,21983,10005,4191,4521,2152,42852,6673,2.23640233969897,0.199479491843498
"12113",129476,2294,7698,35172,29643,16928,24333,13408,119484,37741,2.62369301854968,0.280050567720396
"12115",343723,7021,14689,91967,68864,32916,73434,54832,322013,128266,1.88876775690607,0.142842744523921
"12117",330745,6369,12880,67983,63289,41522,91599,47103,311496,138702,1.53275669494029,0.082595181219498
"12109",189106,3099,6924,41159,33956,17017,53193,33758,179083,86951,2.04195504551767,0.162921796501534
"12111",236957,11073,16845,74500,52495,24677,37637,19730,209039,57367,1.57868783485385,0.144495682630203
"12119",114717,1988,6937,34680,23154,10276,22230,15452,105792,37682,2.13955530829748,0.138697052674007
"12121",30796,2294,2970,12489,6202,1923,2863,2055,25532,4918,2.11615071758031,0.167951006157996
"12123",15988,470,2376,7091,3046,1097,1328,580,13142,1908,2.47104992485907,0.255223008998489
"12125",11772,483,2187,4341,2308,1161,892,400,9102,1292,1.22948588370112,0.0605216758404994
"12127",407582,11555,24591,126964,91735,49138,68388,35211,371436,103599,3.57487188276952,0.30379177437884
"12129",24100,632,2217,8597,5996,1842,2930,1886,21251,4816,2.30440795220732,0.152923571385962
"12131",54160,1265,3488,15313,11198,5299,11448,6149,49407,17597,2.64865651306965,0.279743242966757
"12133",18200,785,2205,7662,4067,1211,1439,831,15210,2270,2.32417685933539,0.150073894731502
"13001",12349,795,1947,4741,2614,1053,653,546,9607,1199,2.03837457760879,0.126252704564501
"13003",5266,939,807,1739,836,372,288,285,3520,573,1.6270508507571,0.0845884290950017
"13005",7300,438,778,2873,1912,492,368,439,6084,807,1.29080136961501,0.0703202594754992
"13007",2139,110,240,730,350,320,202,187,1789,389,1.84325132736988,0.0857139978700049
"13009",27472,1263,2666,8989,5295,2313,4190,2756,23543,6946,1.52996791546797,0.0671028121500002
"13011",12555,926,1974,3997,2529,1059,1224,846,9655,2070,1.04004273267109,0.0594870628185012
"13013",54169,2571,4079,18643,12916,4664,7001,4295,47519,11296,1.04643417187214,0.0411705717900003
"13015",72046,3255,6434,26564,16260,5280,9617,4636,62357,14253,1.52596951998337,0.118955946222502
"13017",11585,610,1270,5796,1727,915,914,353,9705,1267,1.4319230010677,0.0625971340000067
"13019",12546,574,1862,5107,2212,1156,1081,554,10110,1635,1.8220362982037,0.112280781496001
"13021",102514,3962,9990,31471,23262,7656,13612,12561,88562,26173,1.30858522737612,0.0635591178735001
"13023",8170,411,604,2843,2221,787,715,589,7155,1304,1.12045395283378,0.0543935778144979
"13025",12458,518,1813,5641,2518,1159,308,501,10127,809,2.00276514649815,0.109613474913996
"13027",11332,744,1346,3865,2497,977,1251,652,9242,1903,2.07268069920552,0.121531311305296
"13029",27191,644,1454,7363,6095,2525,5718,3392,25093,9110,2.6599426990566,0.111875564641483
"13031",44689,1162,4111,13282,9816,3683,7525,5110,39416,12635,2.19892675471791,0.170941371275998
"13033",15492,816,1675,5636,3294,1724,1722,625,13001,2347,2.48060543526732,0.208845923416995
"13035",17603,614,2704,7289,3689,1162,1409,736,14285,2145,1.1972276235921,0.0471290057570007
"13037",4243,317,677,1619,965,177,315,173,3249,488,1.4909841299068,0.0697683991400015
"13039",34756,686,2157,11216,9884,3233,4590,2990,31913,7580,2.31943612842432,0.167589807991483
"13043",7273,823,767,2784,1547,432,631,289,5683,920,1.03469782805744,0.0617776548355036
"13045",75145,3197,7627,25971,16798,5359,10382,5811,64321,16193,1.74567871457293,0.126721277675441
"13047",46985,1564,3550,15510,12019,3944,6965,3433,41871,10398,1.00447222832771,0.041498884707787
"13049",9078,761,981,3688,1881,673,739,355,7336,1094,2.70157506348997,0.191318845149593
"13051",200334,4957,13843,48789,46799,14736,42640,28570,181534,71210,2.371639236279,0.121934365413095
"13053",4609,72,155,1158,1595,492,747,390,4382,1137,1.39325954950266,0.0622811963763919
"13055",17147,1691,3113,6255,3139,1088,1096,765,12343,1861,1.28715946550637,0.0796879229433629
"13057",178140,5723,8618,40211,40606,14595,47795,20592,163799,68387,1.51881715457904,0.110141425626495
"13059",73044,2660,4855,14054,12370,4805,17059,17241,65529,34300,0.909806606433288,0.0305764676334978
"13061",2141,79,340,648,397,290,256,131,1722,387,1.31757788148731,0.0534842412520725
"13063",183644,10954,15911,60708,41339,17591,24563,12578,156779,37141,1.12405946903632,0.0362866760864992
"13065",4583,521,660,1701,978,221,350,152,3402,502,2.18355344509637,0.201443013205187
"13067",516087,19198,17381,93670,95410,37379,160192,92857,479508,253049,1.29372779423696,0.0870179931525
"13069",28413,2421,4063,11127,4912,1902,2648,1340,21929,3988,2.05820744661369,0.148231261200503
"13071",29903,2750,4304,11510,5014,2014,2374,1937,22849,4311,1.67621245819806,0.136394074909505
"13073",102678,2151,5122,23328,20760,12776,22813,15728,95405,38541,1.34972969065052,0.0773611421543623
"13075",11070,607,1454,3536,2479,1151,1013,830,9009,1843,1.27092398626163,0.0571404507555003
"13077",98082,2857,6463,26095,21201,8441,21768,11257,88762,33025,1.73140500626941,0.111883933432
"13079",8603,368,1243,3425,2052,539,562,414,6992,976,1.60476002463374,0.0813378846414994
"13081",13776,642,1648,5484,2807,1307,1032,856,11486,1888,1.18555086385503,0.0694300889135001
"13083",11139,620,1292,3922,2372,1101,1221,611,9227,1832,1.02567716493124,0.0444578962782971
"13085",18763,542,1638,4392,4796,1248,4163,1984,16583,6147,1.30142776743482,0.0544841332629951
"13087",19242,1309,1686,6864,4441,2133,1725,1084,16247,2809,1.72896766994554,0.15222475641522
"13089",519772,22137,26081,106060,87844,38067,135676,103907,471554,239583,1.23070014996465,0.0683484248649997
"13091",14512,539,1506,5986,3270,953,1550,708,12467,2258,2.01295185506284,0.124596498504003
"13093",8539,411,1294,3657,1398,619,783,377,6834,1160,1.39729227640773,0.0983604064065032
"13095",55875,2681,6505,16603,12570,4867,6938,5711,46689,12649,1.43640136249692,0.0823503254024973
"13097",93017,3523,7353,27374,19608,7826,17000,10333,82141,27333,1.04237003208982,0.0506402022924982
"13099",7028,445,949,2727,1382,516,667,342,5634,1009,1.88947353936217,0.12671442367666
"13101",2550,166,369,1153,444,158,195,65,2015,260,1.57178573481405,0.102668418203139
"13103",41509,1142,2863,15115,8673,3705,7216,2795,37504,10011,2.0004160477433,0.119861350832951
"13105",13785,591,2277,5511,3032,643,1070,661,10917,1731,1.61334173673693,0.0947150754069402
"13107",15046,1106,1881,6501,2445,1189,1263,661,12059,1924,2.32056008282119,0.171684311748998
"13109",7059,482,1129,2694,1211,428,640,475,5448,1115,0.980468860077238,0.0462642225280036
"13111",19588,837,1585,6524,4137,1907,2589,2009,17166,4598,1.85379882810036,0.10013593913388
"13113",80580,1492,2657,16761,15642,6784,22867,14377,76431,37244,1.09906513503483,0.0500794688479994
"13115",65597,4446,6245,21660,14023,5488,8019,5716,54906,13735,1.94140353658814,0.131455190148767
"13117",160396,4463,5762,23420,25830,11232,57284,32405,150171,89689,1.21920559584042,0.0626346021895036
"13119",15784,773,2105,5474,3242,1571,1539,1080,12906,2619,1.24189431135887,0.0675900747594018
"13121",720422,17277,31383,118809,106509,43921,235791,166732,671762,402523,2.75108563118321,0.1347272400215
"13123",22958,1594,1842,8108,4279,2094,3181,1860,19522,5041,1.6656830569422,0.109789561284002
"13125",1954,166,189,801,419,152,201,26,1599,227,0.938164644276161,0.0361852738155025
"13127",59459,2023,4538,16113,13320,5387,11020,7058,52898,18078,1.80015825057068,0.114153693660466
"13129",38638,3520,5470,13102,7778,2543,3620,2605,29648,6225,1.55706427244865,0.0911779211959971
"13131",17588,1411,2153,6595,3417,1324,1563,1125,14024,2688,1.38491807992675,0.112410449730781
"13133",13736,608,1091,4262,2536,864,2757,1618,12037,4375,1.61451629648854,0.102179431754504
"13135",606958,38322,35255,135492,107347,56850,151593,82099,533381,233692,1.57460258899147,0.110346154411499
"13137",30897,2829,3185,10547,5347,1782,4023,3184,24883,7207,1.4915174640903,0.0710455512681674
"13139",132699,14906,10783,37544,27121,9088,20729,12528,107010,33257,1.71695782522914,0.108899528378997
"13141",6809,909,1200,2457,1187,429,510,117,4700,627,1.76283429901569,0.119777318004999
"13143",20449,965,2497,7942,4495,1098,2163,1289,16987,3452,1.1228241737074,0.0714006063222409
"13145",24049,338,1272,6147,6109,2396,4427,3360,22439,7787,1.62474094187696,0.117791451470146
"13147",18826,942,2422,6753,3824,1755,2163,967,15462,3130,1.09994259756198,0.06519941376993
"13149",7841,357,1051,3304,1925,384,461,359,6433,820,1.19391478796315,0.0755183099730695
"13151",153886,3499,8212,48272,34315,16136,28002,15450,142175,43452,1.76311919970457,0.082015299982999
"13153",105717,2397,4992,29772,23823,11722,18793,14218,98328,33011,1.8110135431333,0.0943809186414968
"13155",6689,297,1117,2308,1302,521,536,608,5275,1144,1.58411294433681,0.0893355782489991
"13157",50058,2445,4430,16087,10173,4407,8669,3847,43183,12516,1.45362156879103,0.0868430474170022
"13159",10063,331,916,4400,2093,701,929,693,8816,1622,1.41769431019339,0.0937313852259972
"13161",9611,543,1423,3391,2196,823,838,397,7645,1235,1.55928007302638,0.0827887324699963
"13163",10748,929,1251,4441,2238,695,959,235,8568,1194,1.79443482028825,0.132457278897002
"13165",6234,309,799,2760,1393,472,305,196,5126,501,1.21296767627459,0.0878836724134965
"13167",6729,409,1257,3011,884,557,316,295,5063,611,1.62480901956442,0.0763676192554985
"13169",19462,526,1187,8012,3961,2327,2308,1141,17749,3449,1.35702949274896,0.0988281629890017
"13171",12156,263,991,4416,3465,810,1070,1141,10902,2211,1.01190304931882,0.0464939106939987
"13173",6659,310,666,2875,1110,546,768,384,5683,1152,1.17845864413637,0.0488521704240007
"13175",32996,1262,3232,13762,6416,2823,2800,2701,28502,5501,1.98633012290544,0.203317678714505
"13177",21337,560,1327,5845,4371,2674,4183,2377,19450,6560,1.57802563162536,0.0892338195799993
"13179",37437,924,2284,11447,10880,4531,5119,2252,34229,7371,2.45160631190001,0.133502939174999
"13181",5676,200,735,2480,1077,427,532,225,4741,757,1.42625350715484,0.0648525796860861
"13183",10486,418,1422,3730,2445,934,797,740,8646,1537,1.76210700041541,0.0995546188534997
"13185",69454,2256,5442,22621,14042,6731,11300,7062,61756,18362,2.11208615003731,0.124633614094418
"13187",20937,499,1939,5571,4895,1236,4178,2619,18499,6797,1.34462559853441,0.0723171750320022
"13193",8860,708,1724,3220,1925,389,535,359,6428,894,1.6638784638436,0.100759863588003
"13195",20595,1345,2398,6784,4012,1864,2191,2001,16852,4192,1.42767896519295,0.0722850868270002
"13197",5455,422,835,2000,1026,392,558,222,4198,780,1.48232580592513,0.0911091789325002
"13189",14637,543,1785,5891,2949,1131,1258,1080,12309,2338,1.45422384026084,0.0669198539780001
"13191",8919,224,1252,3232,1899,700,1094,518,7443,1612,2.03007595350805,0.11663296927815
"13199",14599,739,2265,5921,3198,747,1136,593,11595,1729,1.61557499238975,0.126281621093502
"13201",4126,162,454,1194,941,559,460,356,3510,816,1.16787127807091,0.069473490844998
"13205",15088,756,1881,5468,3833,1383,1010,757,12451,1767,1.75616606339425,0.126015648792998
"13207",19354,641,1544,6797,3522,1273,2970,2607,17169,5577,1.44903253573989,0.0995391619805026
"13209",5764,317,783,2161,865,614,592,432,4664,1024,1.33933392434357,0.0606247078684979
"13211",13898,574,885,5055,2612,997,2144,1631,12439,3775,1.33913993487846,0.0891808872830055
"13213",26665,2987,4272,9146,5480,2050,1890,840,19406,2730,1.87116056427422,0.0884293337037936
"13215",133479,4859,10603,35732,33329,12105,22195,14656,118017,36851,1.28375988391824,0.0549420757769617
"13217",71645,2388,5471,23970,18022,6280,9331,6183,63786,15514,1.44080084075979,0.0702110307440012
"13219",26636,290,770,5027,4744,2067,6570,7168,25576,13738,1.20271641524642,0.0470102333609981
"13221",10406,467,1105,3849,1838,934,1362,851,8834,2213,1.75996923094526,0.111554861928998
"13223",108638,2336,7712,32437,28406,9625,18649,9473,98590,28122,1.20365818085901,0.0793841968510023
"13225",17941,974,1712,5674,3671,2010,1898,2002,15255,3900,1.15766793900806,0.037620984425998
"13227",24063,780,2075,8004,5088,2227,3838,2051,21208,5889,1.26689581625862,0.0591128868890019
"13229",13165,743,1084,5561,2301,1442,1109,925,11338,2034,1.64142412061625,0.0842891203939982
"13231",12804,378,1151,4629,2814,1225,1474,1133,11275,2607,1.1184219607904,0.054883337057004
"13233",28327,2066,3047,11679,5773,2024,2373,1365,23214,3738,1.35993165482726,0.0788916203123448
"13235",7415,785,669,2694,1834,503,545,385,5961,930,1.19787151032499,0.0622664637995005
"13237",15848,786,1173,5631,3049,1103,2513,1593,13889,4106,1.44025176040942,0.0904300679104982
"13239",1753,140,405,621,334,94,100,59,1208,159,0.96393321587335,0.0396586694710018
"13241",12715,709,1116,3870,2780,920,1793,1527,10890,3320,1.84062419138293,0.0963541226038508
"13243",4283,355,543,1587,938,330,365,165,3385,530,1.61414273609045,0.106203678285
"13245",135310,4595,13849,43200,30385,12712,18351,12218,116866,30569,1.73251701372698,0.0824517506186516
"13247",61872,2406,4149,17913,14568,5562,10630,6644,55317,17274,0.975696530887598,0.0332526982254989
"13249",3032,115,296,1079,770,308,302,162,2621,464,1.13188767349538,0.0416430331760004
"13251",9985,324,1334,3796,2071,996,746,718,8327,1464,2.24638638474323,0.163382966138766
"13253",6758,332,623,2689,1407,638,724,345,5803,1069,1.26073295897935,0.0627113307301859
"13255",45813,1628,5797,17932,8148,3788,5382,3138,38388,8520,1.26640841177975,0.0500125743410007
"13257",18149,876,2048,7312,3991,961,1800,1161,15225,2961,0.992437648663451,0.046790782914607
"13259",4300,449,797,1498,762,130,413,251,3054,664,1.65476226315998,0.114685688571062
"13261",18763,1309,1817,6903,3372,1718,2145,1499,15637,3644,1.78289983514956,0.121754361642503
"13263",4397,172,623,1835,753,394,383,237,3602,620,1.6406033915018,0.0983115732440001
"13265",1295,110,118,585,316,55,66,45,1067,111,1.36172133445908,0.0491392353140023
"13267",16159,1472,2093,6287,2789,1180,1325,1013,12594,2338,1.95306286264344,0.120736007101495
"13269",5608,429,903,2121,860,427,514,354,4276,868,1.90864470661039,0.0944141096789961
"13271",9067,1182,1504,4041,967,728,318,327,6381,645,1.92279181714367,0.109679636970999
"13273",6148,484,793,2258,1649,307,352,305,4871,657,1.42024106911373,0.0832052874309961
"13275",31272,1202,2913,9587,5884,3756,4928,3002,27157,7930,1.60371105054499,0.134903509314735
"13277",26321,1382,2821,8809,4774,3837,2189,2509,22118,4698,1.15482637271662,0.0660697969025006
"13279",17444,1352,1731,5794,4146,1490,1536,1395,14361,2931,1.49586324411312,0.0918332468510045
"13281",9282,175,519,2627,2124,915,1603,1319,8588,2922,1.19478784899352,0.0438977446515218
"13283",4214,169,876,1778,486,307,454,144,3169,598,1.15649212679699,0.0502572128314983
"13285",45919,1583,4320,16548,10180,4241,5589,3458,40016,9047,1.42299671773579,0.111490736836331
"13287",6186,404,854,2101,1329,821,447,230,4928,677,1.28727793133708,0.0714357265809973
"13289",6110,294,906,2579,1214,434,420,263,4910,683,1.63442788428136,0.0902872372715043
"13291",19082,722,1616,6458,3811,1719,2909,1847,16744,4756,1.64187957814351,0.0840010902457009
"13293",18753,1003,2243,6607,4228,1936,1690,1046,15507,2736,1.44892902798707,0.0817485076049978
"13295",47824,2474,5000,16554,10462,4023,5997,3314,40350,9311,1.68392870022614,0.113976975087119
"13297",64162,1924,5913,21674,14523,5268,9408,5452,56325,14860,1.32677902664435,0.083187854046002
"13299",24532,1355,3111,10273,4392,1891,2340,1170,20066,3510,3.31855517561306,0.221878087392107
"13301",3809,412,672,1466,709,198,228,124,2725,352,1.62261058923005,0.0719599755714984
"13303",14109,749,1509,6497,2233,831,1565,725,11851,2290,2.10879671983686,0.170938803086998
"13305",20392,1169,1988,8933,3755,1785,1679,1083,17235,2762,2.12170207814036,0.159560570388001
"13307",1690,187,141,532,426,175,169,60,1362,229,1.15909031988219,0.0521061641655017
"13309",4364,119,1060,2149,491,146,362,37,3185,399,1.60288450051212,0.0743125070704981
"13311",19722,715,2210,6137,4710,1648,2601,1701,16797,4302,1.20147918237104,0.061692767981998
"13313",66666,9587,8867,20932,12173,3391,6964,4752,48212,11716,1.7743399304543,0.0742591842635112
"13315",6408,305,831,2592,1360,511,453,356,5272,809,1.642905916976,0.094413590421498
"13317",6968,426,910,3176,1218,395,628,215,5632,843,1.83940199627118,0.119527485422497
"13319",6222,270,558,3214,1037,519,391,233,5394,624,1.65926611877293,0.112689369879494
"13321",14662,620,1591,6417,2902,1543,1124,465,12451,1589,1.97077057227502,0.141386396818496
"15001",143340,3280,7005,42111,31406,16298,27845,15395,133055,43240,4.55952637978014,0.900006770762535
"15003",706752,25123,26132,180820,140277,78370,164177,91853,655497,256030,2.75626716814547,0.13965075263119
"15005",47,2,1,13,9,5,10,7,44,17,0.417722170940869,0.00274184074591683
"15007",52464,2143,2010,15503,10847,6189,10862,4910,48311,15772,2.38115929751384,0.142754831310431
"15009",117819,4244,4528,35482,26984,11222,23505,11854,109047,35359,5.08348805261013,0.2624728399146
"16001",330629,5062,11371,68936,79884,30682,88064,46630,314196,134694,2.36313444861969,0.305464142903003
"16003",3427,93,164,1280,1014,242,398,236,3170,634,3.35434418055285,0.403941510739914
"16005",55066,841,2855,14141,15283,6003,10831,5112,51370,15943,3.92367504937298,0.326519120575496
"16007",4107,36,247,1541,1094,405,545,239,3824,784,2.72849560467048,0.296783816488237
"16009",6744,133,824,2448,1485,626,904,324,5787,1228,2.24349179045789,0.241157536177186
"16011",28732,1314,1753,9642,7473,2927,3847,1776,25665,5623,4.37311255671525,0.608318999160014
"16013",16972,706,987,4095,3191,789,5080,2124,15279,7204,7.19513759756864,0.764144642250504
"16015",5989,58,259,1841,1345,822,1041,623,5672,1664,4.59138134125344,0.554094808382496
"16017",34710,737,2075,10541,8685,3444,6210,3018,31898,9228,4.04054205991864,0.602138799349577
"16019",74050,1984,3568,18759,18632,7935,15723,7449,68498,23172,4.15194195152932,0.546756532888923
"16021",8220,374,589,3105,2182,627,983,360,7257,1343,2.96655413063962,0.404941836883791
"16023",1901,53,152,611,523,283,232,47,1696,279,4.26453537837421,0.647618693635497
"16025",718,129,18,190,156,57,118,50,571,168,2.94241299785904,0.310770441095493
"16027",142036,7639,11501,42714,37927,12835,20695,8725,122896,29420,2.15570042829905,0.174339408726223
"16029",4462,161,299,1286,1367,506,579,264,4002,843,3.98491690948802,0.512311953522544
"16031",14539,1045,1236,4264,3876,1396,1978,744,12258,2722,3.88113669625658,0.72952674320339
"16033",520,76,104,141,68,31,66,34,340,100,4.1899433416666,0.51523235823769
"16035",6869,109,411,2409,2151,547,859,383,6349,1242,5.02548408801099,0.757959179031006
"16037",3256,92,331,934,755,249,770,125,2833,895,7.7212937623508,1.44103869446399
"16039",17894,758,1165,5346,4899,2229,2518,979,15971,3497,5.62919167518514,0.891693362799991
"16041",8382,58,550,3917,1991,565,871,430,7774,1301,2.41406772994547,0.188437027774246
"16043",8828,370,642,2520,2361,1057,1444,434,7816,1878,4.1690492246481,0.553136366488468
"16045",13136,395,1208,4513,3362,862,2138,658,11533,2796,2.54116285647829,0.164241658205488
"16047",9903,811,1450,3397,2051,663,1020,511,7642,1531,2.10657641696404,0.209785158764009
"16049",12209,144,814,4034,3142,1393,2021,661,11251,2682,9.67314793174965,2.55063977685882
"16051",17510,599,838,4277,4357,3027,2850,1562,16073,4412,3.00689965879954,0.320369947021499
"16053",14742,1840,1653,4383,3315,1546,1316,689,11249,2005,1.97217111249153,0.171395340751002
"16055",117346,1810,5774,31689,34535,12476,20747,10315,109762,31062,2.7065810535027,0.406153534995088
"16057",23048,219,584,4735,5512,1875,5948,4175,22245,10123,2.56969996359217,0.328785715529311
"16059",6048,98,509,1802,1740,574,879,446,5441,1325,8.30889913630494,1.34929381529528
"16061",2582,80,179,702,813,319,334,155,2323,489,2.47955093456246,0.144937522957003
"16063",3338,344,279,1135,744,443,245,148,2715,393,2.62965070651984,0.344788625501999
"16065",21841,322,636,3796,5991,3158,5800,2138,20883,7938,1.85605784707855,0.137051268612506
"16067",13292,1476,1300,4581,2978,1237,1006,714,10516,1720,2.33261086394573,0.217478666451498
"16069",29174,575,1420,8804,7668,3292,5237,2178,27179,7415,3.00848133886353,0.259069148347823
"16071",2936,65,226,1051,790,144,499,161,2645,660,2.95766907614998,0.33889605106275
"16073",7816,1152,813,2423,1866,523,801,238,5851,1039,7.23911396327373,2.18628005189122
"16075",16470,986,1296,5898,3766,1477,2209,838,14188,3047,1.86475239075744,0.119291208637876
"16077",4896,604,402,1581,1325,308,455,221,3890,676,3.76556373866993,0.410332085153993
"16079",9546,300,807,3530,2855,978,656,420,8439,1076,5.08639305334312,0.814993346897085
"16081",7940,279,325,1413,1561,659,2669,1034,7336,3703,1.68826714990024,0.130379237021099
"16083",56994,3340,4052,15658,13899,6661,8192,5192,49602,13384,3.89086894439619,0.545688725077318
"16085",8994,161,689,2246,2505,740,1668,985,8144,2653,5.79982283818823,1.09907150610551
"16087",7385,502,398,2212,2157,825,813,478,6485,1291,3.13231858606182,0.431450522289077
"17001",45982,902,2573,16058,10307,4332,7837,3973,42507,11810,2.00685455437867,0.237954564332179
"17003",3819,165,362,1441,965,418,303,165,3292,468,1.78435489711067,0.0664129768604634
"17005",11969,357,988,3916,2935,1239,1523,1011,10624,2534,1.34902757210223,0.102943657553502
"17007",35413,2350,2225,11504,7767,2772,5351,3444,30838,8795,1.15002145610873,0.0797976036083952
"17009",4624,208,685,1770,976,384,491,110,3731,601,1.39597211853715,0.0839236411690004
"17011",23710,707,1523,8420,5880,2337,3162,1681,21480,4843,2.24814133690687,0.243632551282994
"17013",3329,74,167,1352,610,549,371,206,3088,577,1.80938528107161,0.0765452191196443
"17015",11394,385,991,4128,2697,930,1636,627,10018,2263,1.76009078641951,0.131577726166749
"17017",8763,566,754,3660,1491,693,1195,404,7443,1599,1.84585261329312,0.104764968069496
"17019",120366,1956,4338,25720,23313,10301,24846,29892,114072,54738,2.10817579704079,0.273294568687502
"17021",24261,476,2093,10141,4742,2396,3268,1145,21692,4413,2.01165710928127,0.194246981770499
"17023",10868,217,539,4057,2024,1493,1661,877,10112,2538,1.72486317430884,0.136581346709052
"17025",9310,369,713,3647,1960,1240,841,540,8228,1381,1.6925352646181,0.126027489639002
"17027",26392,819,1478,8620,5209,4173,4359,1734,24095,6093,2.10173604756859,0.134771834054996
"17029",30525,801,1664,9852,6898,3454,4801,3055,28060,7856,1.63531888007839,0.138377545625996
"17031",3656393,225721,214019,820019,660520,246183,869960,619971,3216653,1489931,2.99775349108475,0.268825596295165
"17033",13781,443,1443,3985,2958,2569,1524,859,11895,2383,1.70584262437724,0.120062407493909
"17035",7419,155,370,2890,1495,1086,980,443,6894,1423,1.33182361623385,0.0937974096455007
"17039",11210,228,543,4709,2562,824,1606,738,10439,2344,1.53136133758443,0.110922209778997
"17037",59792,1876,2528,15101,14306,6137,12193,7651,55388,19844,1.75313469591105,0.178333806225001
"17041",13142,1432,686,4501,2780,1232,1784,727,11024,2511,1.52589620132669,0.113592564287
"17043",642165,21431,20396,116233,110570,48186,195225,130124,600338,325349,1.28398096917921,0.0944554273864988
"17045",12446,528,965,4796,2670,1217,1620,650,10953,2270,1.74897674684089,0.169618606652609
"17047",4417,86,261,1520,1098,863,441,148,4070,589,1.29381126877859,0.0595016414599987
"17049",23719,643,988,7783,5327,3500,3731,1747,22088,5478,1.49836405148426,0.129389955377999
"17051",15258,568,1503,6259,3123,1889,1400,516,13187,1916,2.08151352879255,0.195335628245503
"17053",9445,195,584,3328,2354,931,1233,820,8666,2053,2.24467726408184,0.133980227350496
"17055",26886,694,2115,8800,7189,3326,3437,1325,24077,4762,1.58955606758082,0.114618661756
"17057",24744,501,2094,9143,5725,2763,3160,1358,22149,4518,2.0594609769531,0.24275296786501
"17059",3693,155,287,1447,997,402,246,159,3251,405,1.41154280878965,0.0868454709194733
"17061",8608,250,554,3838,1709,835,994,428,7804,1422,1.81951345956803,0.147891755792003
"17063",34910,818,1412,11068,8909,3404,6100,3199,32680,9299,1.3871194982069,0.119838525927498
"17065",5711,265,411,1847,1483,636,679,390,5035,1069,1.36239478701056,0.115946657737503
"17067",12832,177,669,4415,2763,1659,2192,957,11986,3149,2.01969906558702,0.223749670696381
"17069",2930,165,280,1002,654,437,260,132,2485,392,0.974994063741699,0.0479265054484774
"17071",4865,73,294,2085,1030,480,672,231,4498,903,1.55012749183105,0.109300454100645
"17073",34902,737,1957,12017,7632,4204,5542,2813,32208,8355,1.96493671576109,0.230087264384
"17075",19331,680,1554,7444,4549,2022,2242,840,17097,3082,2.22850609358656,0.308990897955597
"17077",32374,1005,1705,7409,8060,3138,5329,5728,29664,11057,1.81552254369789,0.159546260494882
"17079",6524,174,346,2452,1197,1066,886,403,6004,1289,1.47168883772238,0.134186214718498
"17081",26164,694,1950,8299,6890,3576,3074,1681,23520,4755,1.5897165534318,0.155705203479503
"17083",15002,393,746,5596,2958,1945,2084,1280,13863,3364,1.62538638985628,0.101756455179702
"17085",16506,556,724,5897,3472,1710,2599,1548,15226,4147,1.95614767876054,0.1750719498418
"17087",9661,407,1228,3148,2168,1035,1265,410,8026,1675,1.28812678391193,0.0919712143949988
"17089",340859,25316,22305,76989,68770,24885,78592,44002,293238,122594,1.59326144182085,0.147390028165001
"17091",71628,2739,4751,24927,17332,7018,9417,5444,64138,14861,2.03336774227591,0.189228293117975
"17093",83167,1796,3511,20500,18382,9652,19348,9978,77860,29326,1.21076937140339,0.0901205872364983
"17095",34884,998,2861,12274,7747,4149,4562,2293,31025,6855,1.78518771374215,0.199337191833993
"17097",469459,22575,20555,94568,83838,30472,126816,90635,426329,217451,1.56158261633131,0.133104253830578
"17099",77648,2055,5279,27529,19619,8804,9502,4860,70314,14362,2.54658887882889,0.319918828652001
"17101",11289,492,1273,4137,2402,1485,985,515,9524,1500,1.39791622191336,0.100391601880332
"17103",25105,688,1919,8696,6408,2714,3078,1602,22498,4680,2.06801325667135,0.204250392381503
"17105",25267,767,1725,10598,5824,2115,2818,1420,22775,4238,2.3618152173889,0.289475154911003
"17107",19742,508,1398,7037,4834,1806,2853,1306,17836,4159,1.7247756334846,0.169380015044999
"17115",71824,1499,4427,25424,17377,6245,11184,5668,65898,16852,1.74445419684355,0.159680294220504
"17117",32055,694,2163,12968,7051,3255,4201,1723,29198,5924,1.95082167826037,0.234525953607999
"17119",186145,3679,9351,54017,45805,20301,32914,20078,173115,52992,2.10646862054512,0.198830690330604
"17121",26195,787,2098,9155,6896,3016,2877,1366,23310,4243,1.59068066881355,0.154418548065997
"17123",8580,176,472,3365,2069,954,1065,479,7932,1544,1.71209660056251,0.110541705859496
"17125",9558,346,549,3914,2055,1095,1111,488,8663,1599,2.5231161176485,0.154475673468501
"17127",10224,481,816,3552,2648,1386,960,381,8927,1341,1.18794645887869,0.0636877149114067
"17109",16582,192,629,5454,3233,1732,2713,2629,15761,5342,1.62458915210559,0.162281537264991
"17111",212180,5615,8102,55145,48787,19873,49808,24850,198463,74658,1.69655160347285,0.172914371464133
"17113",104428,1387,2803,24299,20043,8269,31589,16038,100238,47627,2.55654814139326,0.326359725838506
"17129",8665,86,285,2930,2219,1027,1294,824,8294,2118,1.52088853285713,0.0862051335375014
"17131",11260,244,598,4332,2660,1317,1372,737,10418,2109,1.77775605825699,0.158150907089339
"17133",24617,179,976,6299,5649,2393,5683,3438,23462,9121,1.56464179582217,0.10618008811549
"17135",20690,558,1956,8255,4347,1878,2301,1395,18176,3696,2.17286578916663,0.191753107855004
"17137",23134,606,1845,8991,5042,1774,3331,1545,20683,4876,2.01063958221212,0.155729876698
"17139",9828,847,475,3252,2307,1000,1252,695,8506,1947,1.3658197661216,0.0936197093614965
"17141",35978,1178,2077,12261,8650,4046,5021,2745,32723,7766,2.17049593448015,0.214994634258996
"17143",122557,2913,6675,33607,27395,11625,24287,16055,112969,40342,1.86815710496446,0.174144831827501
"17145",15264,566,1934,5654,3631,1702,1250,527,12764,1777,1.57803811235531,0.118884404022501
"17147",11744,153,587,3764,2231,1359,2466,1184,11004,3650,1.47818999915878,0.120073381022997
"17149",10385,198,722,4290,2434,916,1289,536,9465,1825,2.31660736510782,0.230635076817506
"17151",2905,121,195,1254,690,224,291,130,2589,421,1.58466531560979,0.0987547630501541
"17153",3772,113,291,1507,958,348,325,230,3368,555,1.34451240612127,0.0533978754233555
"17155",4112,77,198,1632,884,500,500,321,3837,821,1.04779912026008,0.0478494794080036
"17157",22175,796,2513,8519,5512,1910,1639,1286,18866,2925,1.96119034598821,0.15869062498115
"17159",10998,189,654,3434,2866,1722,1469,664,10155,2133,1.44584628754627,0.0970770312000037
"17161",99470,3730,7188,29460,25062,10584,14972,8474,88552,23446,2.54818211187328,0.125948230497726
"17165",17171,778,1309,5006,4409,2378,2322,969,15084,3291,1.28211815461736,0.102465295269499
"17167",136992,2320,7578,37873,30851,11826,28247,18297,127094,46544,2.47382186033462,0.238735638985
"17169",5320,113,291,2052,1410,530,626,298,4916,924,2.01037250049569,0.120795238020003
"17171",3502,54,156,1556,597,366,581,192,3292,773,1.15473983318136,0.0686679562804993
"17173",15139,231,804,6478,3276,1717,1881,752,14104,2633,2.21289947988528,0.207974978523501
"17163",176442,4023,9608,48222,43596,18710,30619,21664,162811,52283,1.8953232813323,0.180177655775005
"17175",3876,103,301,1515,771,430,548,208,3472,756,1.21225280780318,0.0800459046165008
"17177",31821,759,1817,10676,8418,3358,4503,2290,29245,6793,1.65825124077629,0.159786803267246
"17179",92373,1751,4509,28037,21773,10746,17543,8014,86113,25557,2.05800169861663,0.181040538683997
"17181",12415,520,817,4382,2889,989,1969,849,11078,2818,1.55395215272691,0.111348033138149
"17183",51157,1241,3756,21002,11118,5690,5424,2926,46160,8350,2.10967637027968,0.246837831260257
"17185",8106,136,522,2693,1734,1521,921,579,7448,1500,1.71133000710714,0.0608178455871926
"17187",11013,483,852,3719,2509,984,1676,790,9678,2466,1.55998215888307,0.1501774469805
"17189",9981,309,476,3307,2127,1509,1430,823,9196,2253,2.01306434637554,0.150530626324997
"17191",11402,643,795,3967,2418,1843,1177,559,9964,1736,1.79526782848837,0.191183788344996
"17193",9988,326,704,3407,2342,1590,1067,552,8958,1619,1.95464067279425,0.133476988019947
"17195",39294,1189,2210,14889,9453,4155,4562,2836,35895,7398,1.9774002735275,0.195263950986567
"17197",460589,17586,21660,119617,99135,39685,103790,59116,421343,162906,2.49678638202146,0.236992299364547
"17199",47950,1147,2359,14301,12196,5183,7746,5018,44444,12764,1.41592906552062,0.117624970966998
"17201",194472,8029,14965,60897,46814,18540,29159,16068,171478,45227,1.61262767129749,0.146878168621022
"17203",25947,364,1120,7280,5119,3005,5728,3331,24463,9059,1.86042573490649,0.150014576224502
"18001",21341,2056,877,9456,3669,2205,2069,1009,18408,3078,1.23888611803674,0.0938863341364341
"18003",248919,11146,13589,70255,52473,27058,49906,24492,224184,74398,1.76208788909685,0.183202167195229
"18005",55727,1438,3244,16918,9630,4871,11071,8555,51045,19626,1.41465168136745,0.110607281238002
"18007",5857,191,487,2356,1351,446,806,220,5179,1026,1.38306968743329,0.112001288838707
"18009",8562,196,585,4235,1652,674,729,491,7781,1220,0.865913098348199,0.0455471728129987
"18011",46345,917,1674,8792,7840,4221,14308,8593,43754,22901,1.41896242560879,0.115688248369497
"18013",11846,177,645,4054,2571,1119,2034,1246,11024,3280,1.18195834272702,0.0855164596229968
"18015",14196,400,1149,6022,2914,1627,1467,617,12647,2084,1.46417413110693,0.103293739507502
"18017",26099,1782,2216,10791,5159,2597,2464,1090,22101,3554,1.52966731644896,0.114619562010002
"18019",83820,2093,5528,29348,18912,8866,13103,5970,76199,19073,1.748815226654,0.100631408109846
"18021",18322,431,1183,7618,3687,2417,2078,908,16708,2986,1.470816176566,0.0975809024404983
"18023",21541,1053,1787,9771,3712,2000,2130,1088,18701,3218,1.40996622464605,0.111183570844509
"18025",7432,290,984,3487,1317,482,532,340,6158,872,1.85771712747883,0.0823578247070292
"18027",20685,2962,1823,6965,3318,2787,2044,786,15900,2830,2.18254749334224,0.117169793460998
"18029",35218,827,2427,13463,6493,3237,5904,2867,31964,8771,1.35444366596907,0.0829606385335845
"18031",17777,560,901,7909,3065,1640,2746,956,16316,3702,1.31734551764757,0.100985787652003
"18033",29149,657,1980,12667,5620,2778,4003,1444,26512,5447,1.29919468488116,0.101468483423313
"18035",69793,1480,5174,23450,14942,6989,10299,7459,63139,17758,1.32623805489139,0.108488409114002
"18037",29484,1272,1677,11153,4629,3486,5279,1988,26535,7267,1.48529398106775,0.116227234919502
"18039",130718,10923,12696,45191,25999,9740,17303,8866,107099,26169,1.45601076768383,0.130873604624636
"18041",16418,767,1705,7284,2857,1333,1808,664,13946,2472,1.05443134615316,0.0584577808495025
"18043",55023,1146,3655,16949,11405,5215,10543,6110,50222,16653,0.986254597499406,0.039906121225713
"18045",11508,420,978,5045,2444,1121,988,512,10110,1500,1.44552223315165,0.108888494079998
"18047",15690,689,1149,6327,2933,1240,2163,1189,13852,3352,1.45052637229461,0.105986096366328
"18049",13996,427,1318,5566,3322,1082,1511,770,12251,2281,1.56667542476833,0.102971104380004
"18051",22475,468,1453,9399,4400,2670,2941,1144,20554,4085,2.39806584075236,0.133172421679163
"18053",44272,1623,3560,16692,9378,4361,5095,3563,39089,8658,1.3821220038031,0.114197836008002
"18055",21883,664,1883,8608,4860,2428,2300,1140,19336,3440,1.64366984490852,0.147098124417503
"18057",223841,1889,4294,32280,33743,16135,84106,51394,217658,135500,1.33931239060325,0.11005038560199
"18059",54282,802,2824,16350,11482,5143,11848,5833,50656,17681,1.24425072237936,0.0836434454040025
"18061",27901,635,2089,11739,6001,2199,3500,1738,25177,5238,1.93212435364241,0.129475150392022
"18063",115176,1637,3988,30616,23777,9716,29454,15988,109551,45442,1.41015320985155,0.111276373864504
"18065",34771,778,2422,14851,7554,3065,4008,2093,31571,6101,1.36917990407822,0.107748955117996
"18067",57426,1688,3537,21571,13162,5500,7969,3999,52201,11968,1.39967878565119,0.0808514426689943
"18069",25097,517,1283,10588,4892,2565,3481,1771,23297,5252,1.31305859517275,0.107208052426002
"18071",31136,1220,2161,12941,6892,2462,3799,1661,27755,5460,1.98369756786509,0.138216052141505
"18073",22394,409,1508,10057,4633,1889,2705,1193,20477,3898,1.71143442088097,0.155691316887996
"18075",13759,635,1012,6485,2672,1174,1050,731,12112,1781,1.35502959598458,0.105547955080268
"18077",23039,906,1506,9402,4526,2456,2737,1506,20627,4243,1.71150901795121,0.0974761495235764
"18079",18947,483,1619,8061,4390,1470,2008,916,16845,2924,1.50882624873795,0.101894911687999
"18081",106621,2445,5264,33039,21732,9144,22558,12439,98912,34997,1.18375894565812,0.0872664590675025
"18083",24190,763,1975,8575,4677,3691,2706,1803,21452,4509,3.30724824245585,0.140518337879325
"18085",53603,2665,3912,18695,11129,4177,8353,4672,47026,13025,1.64033916122426,0.154280630858497
"18087",23349,7625,1811,6691,3419,1368,1482,953,13913,2435,1.3929196073883,0.108262330833101
"18089",336230,13149,21137,119068,74541,28670,52450,27215,301944,79665,1.72312044727608,0.140679679505166
"18091",78799,2142,6226,31353,16784,6801,10398,5095,70431,15493,1.78162358559899,0.168796898898092
"18093",31901,1091,2482,12115,6446,3463,3704,2600,28328,6304,1.4311945751231,0.121460672047002
"18095",90655,2347,6936,36143,19523,8467,11403,5836,81372,17239,1.44023534356021,0.123989404494999
"18097",638013,29919,53716,175662,120566,48968,134707,74475,554378,209182,1.36258754817859,0.109742344033499
"18099",30725,1617,2829,11411,6246,2313,4123,2186,26279,6309,1.43415869319232,0.125264365393005
"18101",6872,228,642,2962,1140,908,656,336,6002,992,1.28374790280628,0.091293966588997
"18103",25219,1104,2327,10701,5084,2305,2532,1166,21788,3698,1.46899736041265,0.104226267056504
"18105",81338,1141,3860,17048,14415,6303,19566,19005,76337,38571,1.46505418676623,0.111033670422495
"18107",25828,487,1960,10834,5342,1979,3355,1871,23381,5226,1.4921592791207,0.138153154684999
"18109",49577,1040,4670,19804,10182,4408,6299,3174,43867,9473,1.49065070961455,0.111024935409503
"18111",9947,348,863,4532,2152,885,866,301,8736,1167,1.44717241992881,0.111775274136784
"18113",31763,2986,2464,12525,6088,2519,3607,1574,26313,5181,1.44144130865434,0.116405706734004
"18115",4412,147,324,1878,1006,363,503,191,3941,694,0.904463326713371,0.0235005433491951
"18117",13758,708,1372,6154,2553,1136,1191,644,11678,1835,1.3347144761996,0.109234296658499
"18119",15279,598,1563,6718,3020,1239,1485,656,13118,2141,1.48393332846314,0.104906906432002
"18121",11593,897,856,4495,2669,1172,919,585,9840,1504,1.59996206361504,0.122522294551996
"18123",13675,313,946,6262,2704,1321,1418,711,12416,2129,1.81840774052089,0.102747366963122
"18125",8663,292,728,3910,1682,824,823,404,7643,1227,1.68174693573868,0.0911081053029966
"18127",118889,2280,4778,40921,24578,10368,22088,13876,111831,35964,1.50904909948088,0.117203612837031
"18129",17856,350,957,6514,3682,2023,2897,1433,16549,4330,2.29932815412834,0.111516097868124
"18131",8682,233,878,3954,1863,617,766,371,7571,1137,1.4469969478488,0.120510427199495
"18133",24529,906,1757,10075,5305,2138,2778,1570,21866,4348,1.56309601986415,0.131226057927502
"18135",17112,469,1403,7130,3954,1382,1696,1078,15240,2774,1.42583872434615,0.124064626602212
"18137",19620,571,1361,8045,3835,2038,2117,1653,17688,3770,1.3969149667582,0.120820072714997
"18139",11519,269,914,5234,2309,911,1177,705,10336,1882,1.3338849722308,0.110966306975999
"18143",16728,1021,2162,6963,3087,1272,1528,695,13545,2223,1.21978510484794,0.0516813432905024
"18145",31117,945,2457,13695,5687,2516,4088,1729,27715,5817,1.34100251322779,0.111989323903499
"18147",14172,283,934,5842,2614,1775,1775,949,12955,2724,1.93096660237634,0.106678676416743
"18141",177572,4219,11737,52541,36147,15890,34023,23015,161616,57038,1.6497094785952,0.129033942530682
"18149",16055,835,1482,7194,3442,1194,1324,584,13738,1908,1.33840015698383,0.0869177209115004
"18151",23719,440,1369,9389,4732,2346,3593,1850,21910,5443,1.24382729701095,0.09026645061411
"18153",14945,569,1310,6349,2862,1967,1209,679,13066,1888,1.69769443903373,0.122478308296228
"18155",6745,310,705,3461,1124,527,477,141,5730,618,1.23294096899821,0.0600421361531385
"18157",103486,2554,5125,27859,17988,7936,23201,18823,95807,42024,1.49428704548974,0.138219525731496
"18159",10934,230,803,4454,1696,1043,1840,868,9901,2708,1.13770433913859,0.0715128464305062
"18161",5179,103,507,2030,1040,469,709,321,4569,1030,0.853557655866842,0.0448962763793088
"18163",123080,2858,8284,38933,26006,13491,21924,11584,111938,33508,1.30744875004324,0.0629364823009455
"18165",10883,200,733,4482,2496,1172,1234,566,9950,1800,1.52409213240541,0.0708442236779848
"18167",68771,1588,5538,23086,14969,6347,10001,7242,61645,17243,1.53660706021415,0.111199768059644
"18169",21252,538,1616,9037,3943,1893,2564,1661,19098,4225,1.38958797660723,0.116435770945496
"18171",6040,89,303,2604,1248,707,779,310,5648,1089,1.50273179993602,0.10060598973681
"18173",43859,726,1666,12395,9023,5654,9087,5308,41467,14395,1.64383965952069,0.104030608589628
"18175",19448,920,1673,8252,4096,2010,1835,662,16855,2497,1.85280529281543,0.138348066089997
"18177",45483,1800,3587,16687,10201,4364,5465,3379,40096,8844,1.4046650371156,0.110228120566342
"18179",19007,290,1002,8158,3831,2298,2436,992,17715,3428,1.45558974274217,0.102213033853501
"18181",16950,540,1300,6745,3779,1601,1960,1025,15110,2985,1.79679837457196,0.140488936729007
"18183",23707,624,1240,8679,4754,2936,4013,1461,21843,5474,1.33611506969348,0.0938599841964999
"19001",5280,71,209,2131,1109,733,746,281,5000,1027,1.61069299054434,0.158862892583004
"19003",2669,79,67,960,556,412,482,113,2523,595,1.4306848294813,0.118015804911
"19005",9787,469,475,4008,1848,1291,1171,525,8843,1696,1.84540285606027,0.189219027675095
"19007",8671,359,433,3082,2040,1120,1200,437,7879,1637,1.54088366728166,0.142551108428704
"19009",4041,104,228,1458,954,429,644,224,3709,868,1.50040511357733,0.124169417124503
"19011",17803,339,688,6578,3771,2575,2610,1242,16776,3852,1.806656477346,0.202435504862005
"19013",83659,2469,4130,24857,17677,9822,16151,8553,77060,24704,1.66937187898925,0.162346490252497
"19015",18928,250,858,6104,4022,2847,3592,1255,17820,4847,1.62536435672676,0.161534206060497
"19017",16312,164,409,4959,2798,2490,3616,1876,15739,5492,1.47536176424828,0.1251876127695
"19019",13763,375,484,4825,3154,1976,2099,850,12904,2949,1.66328201276645,0.162492013414505
"19021",13076,1445,1253,4070,2098,1379,1942,889,10378,2831,1.64540626349027,0.165196583641997
"19023",10142,154,440,3708,2307,1595,1514,424,9548,1938,1.64570778348766,0.165618219420999
"19025",7053,85,338,2695,1468,990,1022,455,6630,1477,1.73563530823147,0.162024616550498
"19027",14085,436,378,4813,3257,2083,2382,736,13271,3118,1.61987388056031,0.160580747311003
"19029",9348,258,739,3164,2311,917,1412,547,8351,1959,1.60163970834002,0.157370645099493
"19031",13132,241,343,5086,2868,1733,2080,781,12548,2861,1.63272864463362,0.163196990945004
"19033",30808,608,1391,10283,6290,4876,4994,2366,28809,7360,1.64204692810679,0.164658652551498
"19035",8291,159,378,3324,1684,970,1189,587,7754,1776,1.63984091173986,0.164328489995001
"19037",8191,269,277,3668,1343,1129,1066,439,7645,1505,1.55778744518871,0.144716789708504
"19039",6367,255,731,2644,1210,592,668,267,5381,935,1.43789255006958,0.119704688688504
"19041",11246,87,425,3803,2656,1592,1926,757,10734,2683,1.63934712793038,0.163948350090508
"19043",12325,413,705,5369,2346,1352,1616,524,11207,2140,2.19788320975217,0.22609890255013
"19045",32413,609,1990,12180,6970,3765,4985,1914,29814,6899,2.207562499999,0.199567466834554
"19047",10662,939,1055,3904,2104,866,1356,438,8668,1794,1.85528889961981,0.201353757766999
"19049",63108,1148,1448,11677,10877,6131,21598,10229,60512,31827,1.68889632297253,0.165694162628502
"19051",5641,969,188,1631,982,791,793,287,4484,1080,1.52555992264026,0.139413640289638
"19053",4711,189,287,1774,835,381,682,563,4235,1245,1.55821365379894,0.147279504139616
"19055",12065,240,702,5207,2097,1551,1645,623,11123,2268,1.65340044006015,0.164135831889005
"19057",27209,444,1479,8759,6788,3775,3982,1982,25286,5964,1.56407776126984,0.118997940850567
"19059",12998,202,376,3513,2977,1837,3150,943,12420,4093,1.43851136555062,0.116210697307528
"19061",66015,1354,2770,21391,12377,6934,13860,7329,61891,21189,1.95909611786195,0.174756279354625
"19063",6574,243,431,2281,1454,1091,785,289,5900,1074,1.43356444936904,0.115756487234467
"19065",13574,380,629,5773,2863,1595,1689,645,12565,2334,1.82988371631926,0.208628324966497
"19067",10855,396,385,4218,2108,1540,1610,598,10074,2208,1.55173449964336,0.143475339144001
"19069",7009,286,358,2499,1681,921,1042,222,6365,1264,1.6475382464711,0.165850613127001
"19071",4746,65,185,1739,1203,701,701,152,4496,853,1.62092155022271,0.142686133117642
"19073",6211,97,326,2307,1382,825,966,308,5788,1274,1.62186741534863,0.160854225305999
"19075",8605,96,299,2849,1758,1371,1686,546,8210,2232,1.67888001656129,0.142157546442005
"19077",7568,114,312,2682,1777,1125,1108,450,7142,1558,1.72304127676897,0.166100075546493
"19079",10604,329,360,3502,2107,1735,1934,637,9915,2571,1.71347709197022,0.163502505161008
"19081",7715,125,511,2814,1542,1155,1299,269,7079,1568,1.6400075106124,0.164061965433009
"19083",12295,279,659,4400,2872,1666,1790,629,11357,2419,1.69022827609968,0.161370560974998
"19085",10148,176,617,3944,2377,1074,1414,546,9355,1960,2.16324039505953,0.196444839537588
"19087",13994,435,697,5071,3250,1508,2060,973,12862,3033,1.39049689911761,0.120988738471997
"19089",6389,268,270,2594,1089,1005,865,298,5851,1163,1.52209799441024,0.136187174385376
"19091",6719,144,319,2530,1334,1164,998,230,6256,1228,1.46919320482483,0.124125758544995
"19093",4698,56,291,1866,951,629,709,196,4351,905,1.53933319007903,0.122359854170001
"19095",11583,165,467,4237,2609,1429,1935,741,10951,2676,1.64640970902812,0.164547779475003
"19097",13747,351,540,5773,2954,1470,1826,833,12856,2659,2.07392781103675,0.183324686720243
"19099",26539,526,1028,10572,5809,3525,3529,1550,24985,5079,1.89291452927512,0.2052866490845
"19101",11472,271,558,2859,2088,1307,2506,1883,10643,4389,1.44977377422244,0.121157695310501
"19103",90108,1668,1724,13855,16188,7939,26751,21983,86716,48734,1.84501794286565,0.174478231109498
"19105",14749,213,573,5677,3115,1971,2263,937,13963,3200,1.63086174259403,0.162719727776996
"19107",7032,144,350,3011,1418,912,843,354,6538,1197,1.62547885643715,0.161572767436001
"19109",10484,204,469,3672,2538,1620,1468,513,9811,1981,2.12827313562191,0.279517803329932
"19111",24015,439,1169,8929,5431,3428,3314,1305,22407,4619,1.99070805623084,0.148556895670905
"19113",154712,2247,5648,40139,33043,20559,36509,16567,146817,53076,1.80671893058624,0.204212443460494
"19115",7592,388,786,2832,1549,875,830,332,6418,1162,1.7498443981918,0.11612798363245
"19117",6041,146,287,2605,1529,571,688,215,5608,903,1.44273566487053,0.120483187480995
"19119",7692,214,268,3114,1470,1140,1162,324,7210,1486,2.12561837737175,0.169025474248935
"19121",11143,178,215,3748,2811,1433,1922,836,10750,2758,1.60052767092131,0.156639892497501
"19123",14672,456,723,5807,2892,1714,2226,854,13493,3080,1.61409852944075,0.159746207145499
"19125",22131,505,818,7415,4465,2094,4685,2149,20808,6834,1.61004765127816,0.158934992702502
"19127",26548,2289,1622,9171,4957,3011,3801,1697,22637,5498,1.62412578537251,0.161401950823999
"19129",10170,135,351,3191,2366,1213,1997,917,9684,2914,1.50506158353807,0.122178102303673
"19131",7182,256,264,2501,1452,1167,1143,399,6662,1542,1.51520379358144,0.135057973156702
"19133",6228,153,295,2479,1628,736,688,249,5780,937,2.11775151501813,0.196863370579242
"19135",5170,121,215,2092,1089,630,795,228,4834,1023,1.442499877286,0.120450578896998
"19137",7043,141,409,2446,1681,1050,1008,308,6493,1316,1.42967560934419,0.11788367232901
"19139",28707,978,2005,10026,5602,3523,4554,2019,25724,6573,1.64618331329259,0.125415348615371
"19141",9672,274,539,3535,1950,1316,1593,465,8859,2058,1.63895654246027,0.164097660228002
"19143",4332,229,266,1635,857,607,526,212,3837,738,1.43457410742456,0.114902404793635
"19145",11183,218,668,4341,2657,1366,1374,559,10297,1933,1.59226813218009,0.147866318420803
"19147",6165,118,285,1814,1651,861,1018,418,5762,1436,1.63386167738975,0.163049718411989
"19149",17105,442,521,6031,3448,2596,2938,1129,16142,4067,2.44561024449811,0.245935954395416
"19151",4982,67,455,1819,1073,715,658,195,4460,853,1.64119161047164,0.164711695217999
"19153",324797,11779,12614,80903,62596,33396,84884,38625,300404,123509,1.79359907427574,0.165779912755999
"19155",63252,2241,4110,20559,14412,7462,9875,4593,56901,14468,2.66207845466013,0.267159952511192
"19157",12098,333,372,4659,2087,1062,2038,1547,11393,3585,1.64497833410582,0.164160248999995
"19159",3253,50,169,1289,675,409,442,219,3034,661,1.56356401435148,0.148823764076835
"19161",6964,127,319,2529,1745,985,977,282,6518,1259,1.76270656704239,0.163747144455501
"19163",118214,2378,4789,32952,25128,13273,25050,14644,111047,39694,1.86722655231895,0.131038479583075
"19165",8342,144,400,2913,1877,1173,1382,453,7798,1835,1.7499557000205,0.165642506296993
"19167",21167,792,898,6203,3708,2992,4715,1859,19477,6574,2.34863097718488,0.220114837666169
"19169",52241,359,1284,8786,9328,5799,15665,11020,50598,26685,1.62501197012776,0.161540950983
"19171",11650,467,616,4787,2319,1534,1345,582,10567,1927,1.80631156061047,0.203481555320498
"19173",4090,150,226,1580,852,580,527,175,3714,702,1.57117090611082,0.147637484559793
"19175",8299,174,567,2737,2154,781,1334,552,7558,1886,1.43025565139243,0.118067738211501
"19177",5053,434,182,1930,1103,582,511,311,4437,822,1.5348365909823,0.135505936362992
"19179",24022,1243,1642,8786,5027,2738,2916,1670,21137,4586,1.44591344937166,0.120915556472999
"19181",34216,342,1104,10097,7303,4315,7752,3303,32770,11055,1.69956341375669,0.159619767125501
"19183",15252,558,675,5622,3125,1670,2499,1103,14019,3602,1.65606840918322,0.159028648628498
"19185",4363,270,189,1844,873,526,458,203,3904,661,1.55113469595485,0.145556475099858
"19187",25031,421,1706,8735,5875,3314,3550,1430,22904,4980,1.89340619888985,0.20357184180051
"19189",7226,138,273,2383,1612,1081,1293,446,6815,1739,1.43487826743446,0.115530168342916
"19191",13218,271,273,4478,2232,1917,2453,1594,12674,4047,1.7888717443454,0.198266330247247
"19193",67158,4376,3855,21887,14065,7307,10701,4967,58927,15668,2.42457044419372,0.248537027514401
"19195",5353,102,266,1917,1174,824,749,321,4985,1070,1.43481299486115,0.115615347186179
"19197",8923,176,477,3277,2314,948,1357,374,8270,1731,1.64523294269923,0.165774683142496
"20001",8579,220,410,3104,2321,919,1053,552,7949,1605,1.50323842435302,0.134023818351004
"20003",5217,425,328,1965,1206,435,553,305,4464,858,1.60841186601479,0.155535003175998
"20005",10169,253,362,4315,2272,715,1375,877,9554,2252,1.71850340379226,0.117699635487543
"20007",2910,48,206,1000,635,302,513,206,2656,719,2.27076910743622,0.298718244032189
"20009",17416,676,1300,5358,4531,1917,2550,1084,15440,3634,1.97725988562185,0.240839620457499
"20011",9484,342,595,2992,2402,920,1484,749,8547,2233,1.66960578112814,0.169442603099159
"20013",6435,61,357,2446,1618,725,917,311,6017,1228,1.59190341068915,0.15588127484422
"20015",44217,835,1952,11754,10824,4586,9254,5012,41430,14266,2.48151359317988,0.383213751292508
"20017",1814,47,71,580,440,144,410,122,1696,532,1.84383976185862,0.207459620821502
"20019",2433,69,222,814,688,271,260,109,2142,369,1.72606391050193,0.169397438075674
"20021",13453,459,1110,4311,3713,1218,1695,947,11884,2642,1.59314055305845,0.155277789356845
"20023",1916,27,124,642,494,215,314,100,1765,414,2.14551035068703,0.277341613887575
"20025",1412,30,50,412,362,172,307,79,1332,386,2.06898914020391,0.25706704996903
"20027",5647,127,203,2037,1351,472,954,503,5317,1457,1.6889606073883,0.177427783595996
"20029",6020,157,143,1910,1538,928,809,535,5720,1344,1.82107117045349,0.194679905365999
"20031",5877,129,233,1912,1650,617,941,395,5515,1336,1.6898920721064,0.174301069356004
"20033",1323,22,34,426,479,122,192,48,1267,240,1.84933112794285,0.207591566030351
"20035",22873,692,1164,6851,5872,2773,3492,2029,21017,5521,2.20543104977791,0.297793973805673
"20037",23446,653,937,6811,5821,2159,4494,2571,21856,7065,1.61037967578345,0.157042625051316
"20039",2026,28,105,673,542,226,375,77,1893,452,1.99067283317595,0.243478343923893
"20041",12995,228,637,4101,3498,1351,2325,855,12130,3180,2.07949866167988,0.229023664945002
"20043",4955,186,252,1701,1486,403,610,317,4517,927,1.8082334143799,0.108439225356267
"20045",69820,679,1934,13046,13064,4553,20103,16441,67207,36544,1.6359625359627,0.127614448144502
"20047",2092,127,138,707,533,207,288,92,1827,380,1.81976769168575,0.165025064524994
"20049",1774,57,170,670,457,101,190,129,1547,319,1.73691370429571,0.171575285167004
"20051",17798,290,772,4888,3555,1633,4254,2406,16736,6660,1.9825872695723,0.242198606660498
"20053",4623,79,306,1595,1279,402,636,326,4238,962,1.81913337468595,0.193981740459993
"20055",22679,3614,2774,5447,5063,1757,2587,1437,16291,4024,2.83435384768524,0.3463116096425
"20057",20615,3292,1849,4962,4113,2176,2627,1596,15474,4223,2.22470252565103,0.2907729022875
"20059",17394,487,768,6526,4087,1522,2511,1493,16139,4004,1.60073511655212,0.154489597103004
"20061",19685,477,739,4880,6118,2775,3091,1605,18469,4696,1.71574039428161,0.108990706704996
"20063",1917,36,73,753,435,244,289,87,1808,376,2.19751762289548,0.288249114672497
"20065",1770,39,71,628,371,194,366,101,1660,467,1.98879927126426,0.243233837024503
"20067",4393,858,60,1043,931,443,745,313,3475,1058,1.57069102157107,0.151952724339496
"20069",3511,608,179,804,758,352,648,162,2724,810,1.95360408799655,0.230122385584501
"20071",805,72,26,189,155,127,152,84,707,236,1.82692895266812,0.208172611920044
"20073",4384,105,230,1602,1274,401,519,253,4049,772,2.26430556252826,0.305717034706994
"20075",1630,132,174,650,257,100,242,75,1324,317,2.08389565430086,0.265055807310869
"20077",3753,123,287,1433,1033,247,390,240,3343,630,1.86397868923218,0.211011734761309
"20079",22573,906,975,5233,5916,2321,4849,2373,20692,7222,1.62380022240484,0.143742800012499
"20081",2409,451,215,559,599,217,227,141,1743,368,1.57171617842975,0.152599614454501
"20083",1271,53,56,310,323,145,295,89,1162,384,2.01146602035777,0.228825982739999
"20085",8875,141,364,3560,2254,678,1186,692,8370,1878,1.81651548927427,0.178259533362501
"20087",12955,188,479,5079,3035,988,2080,1106,12288,3186,1.61443163835357,0.150407037670492
"20089",2172,38,120,808,544,234,312,116,2014,428,2.01607019921343,0.249006558664662
"20091",410368,6077,9230,56510,76150,31252,140396,90753,395061,231149,1.55428076840282,0.129019391032566
"20093",2348,314,209,838,341,195,272,179,1825,451,1.96139052921147,0.231361515430498
"20095",5332,119,352,1675,1595,405,863,323,4861,1186,2.01126001233886,0.228914463166004
"20097",1592,55,134,462,376,174,290,101,1403,391,1.79339398995004,0.190879854942505
"20099",13739,488,877,4282,3343,1686,1995,1068,12374,3063,1.664405477969,0.171687288888929
"20101",1080,0,46,307,336,134,145,112,1034,257,1.75313858175361,0.1918543879505
"20103",55401,1246,2658,15525,12109,4672,11230,7961,51497,19191,1.82621043274176,0.12659256331848
"20105",2054,34,58,538,670,246,312,196,1962,508,1.82230000640227,0.194151663106999
"20107",6852,128,305,2653,1765,596,938,467,6419,1405,1.6309335737808,0.161545480423275
"20109",1892,86,56,588,484,292,310,76,1750,386,2.20044976069977,0.288648270913505
"20111",19288,1263,983,6103,4382,1412,3096,2049,17042,5145,1.95293714105222,0.228674622646994
"20115",8119,214,450,2441,2013,764,1518,719,7455,2237,2.1514322598774,0.254561545589494
"20117",6918,208,386,2719,1465,842,794,504,6324,1298,2.00377712454034,0.246404057776946
"20113",20382,912,777,5298,5084,2258,4089,1964,18693,6053,1.97804587755973,0.240512800323998
"20119",2620,216,190,602,675,351,379,207,2214,586,2.07157583541672,0.257587902583168
"20121",23049,396,689,6932,5496,1976,4949,2611,21964,7560,1.60672858629279,0.157981480457194
"20123",3907,27,175,1004,1103,586,750,262,3705,1012,1.81502146716621,0.194757013611505
"20125",21559,577,1571,6889,5652,2453,3052,1365,19411,4417,1.65801581166313,0.171254935353716
"20127",3944,102,182,1394,905,365,703,293,3660,996,1.85229794246517,0.188474680560505
"20129",1811,94,128,651,373,253,226,86,1589,312,1.76123136073249,0.191781203091201
"20131",6591,177,255,2458,1078,770,1224,629,6159,1853,1.77007983266044,0.19586110135199
"20133",10555,314,634,3221,2771,1450,1456,709,9607,2165,1.57252093369977,0.152587152501999
"20135",1891,71,90,626,474,215,326,89,1730,415,2.19278214543362,0.287532029475498
"20137",3997,73,317,1231,1139,306,678,253,3607,931,1.97435215735122,0.239979801223223
"20139",10953,248,657,4276,2547,884,1589,752,10048,2341,1.77078749650486,0.192923755548503
"20141",2546,72,78,871,622,356,410,137,2396,547,1.98496097362374,0.242021288907997
"20143",4038,51,152,1341,1270,366,623,235,3835,858,1.81464293143225,0.194624241705496
"20145",4890,112,341,1613,1420,451,697,256,4437,953,2.03880038308901,0.200979541870506
"20147",3528,103,218,1213,815,422,537,220,3207,757,1.98872081972746,0.24359150493502
"20149",15838,139,544,4633,3260,1448,3811,2003,15155,5814,2.63616995555759,0.233287714288004
"20151",6009,161,269,1628,1460,563,1218,710,5579,1928,1.80523005287993,0.194549210923503
"20153",1873,24,61,517,575,290,318,88,1788,406,2.21358953052875,0.291901156970668
"20155",42710,1063,2661,12859,12316,4970,5838,3003,38986,8841,2.45504543303756,0.337712088906502
"20157",3352,56,105,1053,750,513,557,318,3191,875,1.82190012808083,0.196268681650097
"20159",6084,107,326,1892,1885,505,895,474,5651,1369,1.84443140132458,0.194348175139003
"20161",37213,512,935,5987,8417,3436,9852,8074,35766,17926,2.7184486476386,0.168220099418006
"20163",3529,74,262,1171,830,463,552,177,3193,729,1.98572675678694,0.2423066891165
"20165",2069,40,117,664,602,223,337,86,1912,423,1.80021791607278,0.1920363166245
"20167",4727,93,234,1353,1423,605,692,327,4400,1019,1.98275361899652,0.241940005020013
"20169",36767,706,1741,10860,9745,3489,6735,3491,34320,10226,1.82857085306989,0.193686007825006
"20171",3337,167,367,926,909,169,518,281,2803,799,1.75334078797515,0.191926804850002
"20173",338734,14082,21305,89149,79881,28683,67632,38002,303347,105634,2.19116817441519,0.266948599383005
"20175",12905,2415,1402,4006,2606,1015,1041,420,9088,1461,1.64512545407736,0.168324702625626
"20177",121755,3092,5187,36966,28147,9062,25258,14043,113476,39301,1.81984238492243,0.149764880453995
"20179",1707,33,38,578,377,291,287,103,1636,390,1.98559234533493,0.242574685300502
"20181",3759,131,235,1162,867,559,615,190,3393,805,2.18456948992195,0.285877464308249
"20183",2634,51,50,1036,614,320,424,139,2533,563,1.99243513381218,0.244232215717006
"20185",2786,64,153,862,608,364,522,213,2569,735,1.97156071568073,0.211253595602002
"20187",1296,87,152,495,263,105,136,58,1057,194,1.72819509614026,0.179676184142938
"20189",3287,258,601,883,893,250,266,136,2428,402,1.76083528641603,0.191270745602877
"20191",15246,314,701,5328,3613,1410,2779,1101,14231,3880,2.26489309517014,0.311610274984172
"20193",5023,129,269,1164,1543,705,745,468,4625,1213,2.2073208372486,0.290908125117496
"20195",2151,26,88,633,514,379,383,128,2037,511,1.98268928196045,0.242043537320997
"20197",4719,28,141,1758,1093,552,717,430,4550,1147,2.1876559777897,0.215250692584
"20199",1070,33,13,300,285,136,242,61,1024,303,2.00022670841474,0.245817192166065
"20201",3858,86,158,1589,787,373,564,301,3614,865,1.99555199375189,0.244667644556335
"20203",1552,34,174,490,390,184,219,61,1344,280,1.75344152291586,0.192136307764994
"20205",6016,178,384,2250,1506,594,828,276,5454,1104,1.56810617930725,0.151927290383998
"20207",2355,14,207,905,527,221,345,136,2134,481,1.49584735811074,0.134013972469992
"20209",106831,9847,10274,34494,22565,9067,13564,7020,86710,20584,1.03886283422877,0.0421087760773618
"21001",12596,956,910,4962,2142,1240,1088,1298,10730,2386,1.42816297104515,0.108255974648002
"21003",14198,1083,916,5909,2547,1272,1542,929,12199,2471,1.72444024963911,0.0920099407423404
"21005",16263,519,923,5565,3549,1592,2627,1488,14821,4115,1.47585852291514,0.0542736681494992
"21007",5551,216,383,2178,1282,598,597,297,4952,894,1.25721773439836,0.0718749215247159
"21009",30484,2172,2631,13133,4990,2324,3275,1959,25681,5234,1.87240956064945,0.131036835392501
"21011",8408,740,772,3695,1483,468,730,520,6896,1250,2.06893772954869,0.0755855091320019
"21013",17278,1860,2404,7270,2912,1115,978,739,13014,1717,1.73666689601794,0.0943579818321071
"21015",88761,2273,3779,25378,19201,7989,19001,11140,82709,30141,1.17647006839714,0.0690629090571493
"21017",13937,916,1064,4787,3131,824,1758,1457,11957,3215,1.71523880841746,0.0776896823635005
"21019",34594,1097,2967,11307,8201,3893,4017,3112,30530,7129,0.983268372566897,0.0432461893402994
"21021",20363,681,1417,7175,4116,1537,3108,2329,18265,5437,1.28061975080948,0.0483263016265005
"21023",5766,212,430,2707,1119,550,390,358,5124,748,1.2592735020713,0.0560252267681967
"21025",9774,785,1418,3752,1552,619,696,952,7571,1648,2.36610466345691,0.130731239509497
"21027",14037,523,1429,6224,2979,895,1163,824,12085,1987,2.13701231110045,0.155105566509876
"21029",57667,1782,4278,23540,13092,5687,6045,3243,51607,9288,1.58843699284987,0.0797474175110006
"21031",8680,680,984,3985,1255,577,593,606,7016,1199,2.06163748424188,0.113470878292497
"21033",8870,237,923,3630,1789,771,796,724,7710,1520,1.88922842802247,0.0914312499074964
"21035",23229,776,1499,7286,4801,1525,4028,3314,20954,7342,1.33695403475643,0.107206775250783
"21037",64188,1400,3086,17108,12256,5494,15663,9181,59702,24844,1.11625251077443,0.0429798591819687
"21039",3319,181,307,1582,625,208,276,140,2831,416,1.23161053296013,0.0520650689471205
"21041",7124,503,868,3010,1784,488,301,170,5753,471,1.04644901107223,0.0368098349796857
"21043",18305,1741,2011,7312,3406,1474,1342,1019,14553,2361,1.99048053516758,0.109956507917001
"21045",11010,1679,1134,4455,1766,704,636,636,8197,1272,1.55734726049089,0.117356509891498
"21047",41041,2205,3467,12978,10532,4342,4888,2629,35369,7517,2.05854326248729,0.189532413394074
"21049",25876,1126,1661,9425,5896,2579,3261,1928,23089,5189,1.49965615167849,0.0677474786824999
"21051",14715,2159,2499,5566,2256,544,866,825,10057,1691,1.96663329190739,0.123784716635002
"21053",6695,632,834,2572,1061,669,494,433,5229,927,1.1432977858148,0.0537160945558507
"21055",6363,390,516,2799,1298,536,521,303,5457,824,2.13509948748575,0.0977590600983268
"21057",4351,343,543,1991,701,188,380,205,3465,585,1.38905314142496,0.0812590467640732
"21059",68842,1926,4321,23268,14654,7456,10622,6595,62595,17217,2.10502780192607,0.126162771250006
"21061",8832,730,957,4047,1579,622,441,456,7145,897,1.1988243663194,0.0809226266479997
"21063",5502,709,660,2545,894,202,285,207,4133,492,1.47387939062606,0.0626261113195002
"21065",10092,1274,1323,4329,1431,664,738,333,7495,1071,1.63851766099293,0.0676485386204992
"21067",209217,6375,9602,39476,41878,16456,54085,41345,193240,95430,1.53780902428094,0.0758961398120042
"21069",10146,778,1118,4094,1535,1030,1043,548,8250,1591,2.0296506454023,0.093800556091501
"21071",25341,2622,3172,9876,4974,1500,1868,1329,19547,3197,1.9924406938032,0.104517951314997
"21073",36099,1419,1985,10924,8262,2806,6416,4287,32695,10703,1.10807866498824,0.0565194132449981
"21075",4545,370,539,1775,987,250,463,161,3636,624,1.69602469449354,0.0600975091605083
"21077",5818,318,556,2885,1085,368,463,143,4944,606,1.02382274598666,0.0281161824916073
"21079",12240,528,1251,4669,2204,1084,1176,1328,10461,2504,2.0498670111083,0.0618497945640018
"21081",15920,463,1405,7209,3275,1179,1448,941,14052,2389,1.15505457362261,0.0698941077140005
"21083",24755,816,1791,10073,4831,2795,2500,1949,22148,4449,1.54530625099164,0.145467809864815
"21085",17891,1123,1878,8145,3447,1258,1143,897,14890,2040,2.76471096688971,0.134820473622997
"21087",8000,924,611,3267,1534,551,636,477,6465,1113,1.25742311159581,0.0759407635590055
"21089",25623,1057,1459,9361,5928,3515,2336,1967,23107,4303,1.58827524603871,0.0948479949618499
"21091",6113,244,640,2610,1033,650,627,309,5229,936,1.39726026513757,0.0527159195972678
"21093",72957,1597,4224,22325,19820,8505,9645,6841,67136,16486,2.35372558635378,0.166775235707889
"21095",18841,2032,2706,6741,3676,1893,804,989,14103,1793,2.02868697155159,0.12252612655664
"21097",12994,743,1203,5260,2627,893,1142,1126,11048,2268,1.59562299935937,0.082810405008998
"21099",12846,1255,1574,5507,2255,898,826,531,10017,1357,1.87430056588445,0.109971916270501
"21101",31317,969,2640,11906,7289,2873,3373,2267,27708,5640,2.10861162474978,0.123315224811173
"21103",10705,634,1048,4472,2347,723,930,551,9023,1481,1.48360901799531,0.0778015228625021
"21105",3240,142,224,1264,582,239,594,195,2874,789,1.26299974958644,0.0660395662432066
"21107",31654,1427,2469,12640,6808,3100,2940,2270,27758,5210,2.59408064507119,0.145938939850498
"21109",9171,1064,1564,4043,1152,514,547,287,6543,834,1.48413551150128,0.0913586047005004
"21111",540240,14742,32513,142247,117780,43920,112266,76772,492985,189038,1.59532958143972,0.105897316517517
"21113",35156,964,2662,11166,6532,3412,5882,4538,31530,10420,1.20446419748992,0.0462888689990011
"21115",16033,1021,1695,6345,3000,1387,1380,1205,13317,2585,1.52427275557991,0.0700339289520077
"21117",114711,3351,6347,31465,22606,10193,25734,15015,105013,40749,1.09133489606115,0.044195249583161
"21119",10076,1438,1543,2975,1683,821,718,898,7095,1616,1.66182937521591,0.0929325401945001
"21121",20385,2562,2325,7944,3384,1053,1598,1519,15498,3117,1.85697144615268,0.101528082215502
"21123",10511,643,1374,3550,2186,982,636,1140,8494,1776,1.7716683583772,0.0696234407795003
"21125",42839,2866,4635,16940,8566,3219,3654,2959,35338,6613,2.2635924903885,0.116494733327997
"21127",11336,1051,1622,4827,1908,550,782,596,8663,1378,2.04421044707623,0.111695879517428
"21129",5322,645,796,2176,1017,269,272,147,3881,419,1.14661028197797,0.0558097593445017
"21131",7406,411,808,3395,1457,656,490,189,6187,679,1.79421571466424,0.106163755913502
"21133",15566,1492,2095,5537,2976,1866,748,852,11979,1600,1.90328725657169,0.0890274120593309
"21135",9157,1136,955,4012,1483,763,466,342,7066,808,2.28349276234131,0.132498098646856
"21137",16785,1218,1744,7378,2920,1221,1299,1005,13823,2304,1.49438186542755,0.0887277770284988
"21139",6575,186,708,2742,1509,473,571,386,5681,957,1.7144645834843,0.0899193651729663
"21141",18688,1008,1324,8174,3670,1353,1836,1323,16356,3159,1.54581153511811,0.145801063228063
"21143",6854,233,505,3074,1339,721,513,469,6116,982,1.22955626437515,0.0673160605880025
"21151",56802,2317,3554,15409,11027,5530,11246,7719,50931,18965,2.07366985927367,0.117319416415
"21153",8295,1125,1188,3128,1518,428,361,547,5982,908,1.72993989874127,0.0818024482749983
"21155",13309,753,1208,5879,2203,1390,932,944,11348,1876,1.57631719582173,0.0916042113765006
"21157",23036,833,1058,8201,5776,2236,2901,2031,21145,4932,1.20815464524332,0.0890450414759966
"21159",8329,1018,1171,2968,1495,693,714,270,6140,984,1.52551104900547,0.0611173982550865
"21161",11839,758,888,3662,2487,1420,1379,1245,10193,2624,1.09529998126884,0.0660073017624615
"21145",47304,1035,2547,15235,10792,5063,7833,4799,43722,12632,1.23245894697707,0.0702802155746508
"21147",11811,1170,1432,4903,2325,1153,526,302,9209,828,1.94984130000169,0.112649061917559
"21149",6410,276,364,2494,1557,606,714,399,5770,1113,1.39372100713065,0.0676425146744997
"21163",20644,618,1590,8187,4567,2101,2055,1526,18436,3581,1.70630356889663,0.0860995745812404
"21165",4324,504,507,1867,687,281,332,146,3313,478,1.28838795615778,0.0546690972614989
"21167",15649,785,1073,5452,3413,1785,1721,1420,13791,3141,1.60513822162488,0.0671226802524991
"21169",7127,715,601,3068,1154,608,570,411,5811,981,1.24542352103248,0.0763446359799968
"21171",7796,703,799,3219,1414,508,423,730,6294,1153,1.43525035917771,0.0867545773437277
"21173",19109,1081,1707,7926,3834,1366,1842,1353,16321,3195,1.11875780275611,0.0528600436629996
"21175",10181,1125,1226,4052,1690,528,777,783,7830,1560,2.15741633959535,0.101859098554999
"21177",22041,1255,2415,9426,4119,2191,1524,1111,18371,2635,2.53591494754198,0.126056336007503
"21179",31833,730,1777,11599,7292,3801,3953,2681,29326,6634,2.60437039618666,0.112370232531999
"21181",5176,299,680,2394,891,435,254,223,4197,477,1.37464203297144,0.0525302056040031
"21183",16378,1465,1596,6444,3086,1401,1214,1172,13317,2386,2.28738140349572,0.157299078002
"21185",44918,1005,1723,8888,9451,3905,11540,8406,42190,19946,1.07575144067139,0.0524741674770737
"21187",7772,571,761,3218,1100,714,1070,338,6440,1408,1.81114113492862,0.0947644499560002
"21189",2985,539,400,1236,367,99,211,133,2046,344,1.45099397287233,0.0522709308454979
"21191",10050,554,1113,4320,1657,803,929,674,8383,1603,1.24468476511474,0.075604714374354
"21193",19798,1900,2488,6460,4288,1890,1101,1671,15410,2772,2.56092579824199,0.0901028130344991
"21195",41918,3927,4925,16537,6891,3046,3530,3062,33066,6592,2.79750545758762,0.208044771923976
"21197",8887,726,873,3852,1371,598,924,543,7288,1467,1.24826283789306,0.0477441907925009
"21199",45475,3529,4011,15602,10154,4374,4328,3477,37935,7805,1.89233658003577,0.177669931779001
"21201",1543,90,146,621,278,196,185,27,1307,212,0.966907311878576,0.0267823598294994
"21203",11500,1120,1130,5006,2363,485,725,671,9250,1396,1.54793960467825,0.0838880247589995
"21205",14348,809,1071,4949,2634,1179,1618,2088,12468,3706,2.12985616462069,0.076247671706999
"21207",12342,984,1253,4630,2393,1088,1070,924,10105,1994,1.33562858546073,0.0741866173084985
"21209",36906,774,1596,11159,8986,3419,6616,4356,34536,10972,1.45051581547176,0.0761317609869996
"21211",32759,1521,2711,9421,6526,3161,5776,3643,28527,9419,1.52276277203459,0.1027424300335
"21213",12963,358,1006,5773,2687,1350,1150,639,11599,1789,1.11312457926771,0.0617830269158716
"21215",13410,328,729,5136,3041,1175,1984,1017,12353,3001,1.07288347408978,0.0509378842304987
"21217",16986,712,1475,6220,3533,1344,2192,1510,14799,3702,1.59672336020636,0.0729699890799973
"21219",7966,950,710,3163,1424,545,634,540,6306,1174,1.42155058597421,0.0986742331021932
"21221",9967,437,671,3244,2472,1045,1345,753,8859,2098,1.49386619753907,0.125818900142871
"21223",6039,203,772,2757,927,490,554,336,5064,890,0.909853613988511,0.0418467561938888
"21225",9146,241,558,4243,2075,1103,570,356,8347,926,1.60777988198681,0.0960969295597321
"21227",81280,4408,5479,21991,16105,7009,15966,10322,71393,26288,1.77242429055683,0.143553144057999
"21229",8270,504,598,3429,1379,644,975,741,7168,1716,1.61892785187547,0.0797516602840017
"21231",14048,1630,1574,5467,2357,787,1374,859,10844,2233,1.73237242554249,0.126604200420153
"21233",8853,488,822,4194,1690,773,582,304,7543,886,1.62732299513118,0.0886157735344953
"21235",23155,1404,2649,9072,4304,1172,2155,2399,19102,4554,1.890813368847,0.116327375136144
"21237",4544,477,1072,1520,840,337,118,180,2995,298,1.45951947482319,0.0589743277920009
"21239",18559,503,1012,4947,3268,1471,4352,3006,17044,7358,1.47006962001447,0.0510358787380002
"22001",38314,3282,4264,16454,6231,2867,3738,1478,30768,5216,2.30473632038526,0.159695791825998
"22003",16245,889,2396,7038,2926,1025,1404,567,12960,1971,2.07751196376847,0.186750966071999
"22005",81640,3170,6065,23770,18032,7156,16310,7137,72405,23447,1.54144455207372,0.0734389994249975
"22007",14934,1252,2219,6465,2539,846,1046,567,11463,1613,1.46448032091193,0.0894969562175024
"22009",27356,1697,4713,9771,6039,1769,2088,1279,20946,3367,2.56198527044668,0.211892055100003
"22011",24337,986,2057,9491,5128,2223,2944,1508,21294,4452,2.93645769699825,0.284202736691869
"22013",9232,321,924,4427,1724,682,853,301,7987,1154,2.35071899534519,0.203930490042003
"22015",85283,2314,5903,25117,21543,7571,14622,8213,77066,22835,3.85578138896978,0.215894940492639
"22017",162773,5596,16297,52222,37617,11968,22427,16646,140880,39073,4.11758824622292,0.232995966677821
"22019",140837,4651,12008,48394,30665,11605,22306,11208,124178,33514,2.88258062599151,0.265537156430341
"22021",6728,481,1079,3185,965,201,625,192,5168,817,1.96650383175394,0.133813509650499
"22023",3945,109,439,1453,851,417,438,238,3397,676,3.35197284832944,0.396568257123576
"22025",6482,492,1269,2456,911,351,657,346,4721,1003,3.46807267296385,0.182149589060997
"22027",10729,600,1769,4935,1680,434,823,488,8360,1311,1.94674873609817,0.191341157688055
"22029",12677,1034,1354,5470,2165,691,1262,701,10289,1963,3.72684052251096,0.18363813333612
"22031",18319,1027,2184,7636,3584,1243,1682,963,15108,2645,2.34934084830814,0.22122974118455
"22033",289379,8703,18965,74591,62705,15867,64735,43813,261711,108548,2.22097476105837,0.114516092938499
"22035",4960,294,1414,1769,840,137,445,61,3252,506,2.4494389353684,0.110295124449189
"22037",14548,549,2179,5871,2703,931,1660,655,11820,2315,1.84719346085264,0.111286528964684
"22039",21435,2334,3037,8465,3373,1531,2071,624,16064,2695,1.99970019288948,0.165781506104996
"22041",13397,1133,1967,5483,2175,656,1279,704,10297,1983,2.85454406775843,0.1572028249575
"22043",15926,876,2116,6646,3250,1205,1462,371,12934,1833,2.76449127747015,0.163639012011504
"22045",46229,2862,4760,20129,8006,3791,5085,1596,38607,6681,3.18245922932124,0.149842072310382
"22047",21744,1711,2673,8640,3544,1773,2257,1146,17360,3403,2.16082316947833,0.158503010712502
"22049",10798,628,1175,4783,2001,875,972,364,8995,1336,1.69275558884229,0.144026931656995
"22051",309014,16579,24237,90304,69173,20180,57776,30765,268198,88541,3.26429065105251,0.123520597798937
"22053",21552,1205,2472,9310,3736,1270,1984,1575,17875,3559,2.54249135545259,0.159914075111003
"22055",162259,6017,11340,48271,32247,9344,37013,18027,144902,55040,1.49189685635184,0.0653269938360031
"22057",66847,5021,7732,27700,10599,4199,7690,3906,54094,11596,4.12985518897621,0.299231930830394
"22059",9906,576,1299,3917,1699,735,1156,524,8031,1680,2.4831569872267,0.163232381744003
"22061",26493,946,2002,7217,4912,1452,5938,4026,23545,9964,1.55611077444496,0.117516712550001
"22063",93440,4029,7785,34643,21313,6747,13383,5540,81626,18923,2.20314168639224,0.168173569128999
"22065",6779,572,1093,2213,1533,346,764,258,5114,1022,3.0416296372331,0.16144806355267
"22067",17455,1053,2433,7169,3463,1334,1502,501,13969,2003,2.61814349195859,0.201026812818386
"22069",22733,696,2269,8634,3914,2304,2963,1953,19768,4916,3.59020653141743,0.320275956458492
"22071",274825,9638,22860,61685,59306,13875,60202,47259,242327,107461,1.85194005626426,0.0843835395260075
"22073",104736,3598,8778,34905,25029,6400,17154,8872,92360,26026,1.9611811833185,0.156940052936497
"22075",15367,1282,1040,5444,3888,1080,1930,703,13045,2633,6.35939911302106,0.28688317965206
"22077",14619,942,1815,5424,3254,959,1731,494,11862,2225,2.39109980797089,0.143974754528999
"22079",86707,3943,7325,32582,18635,5547,11932,6743,75439,18675,3.48750117076826,0.333691319834499
"22081",5255,187,786,2689,740,204,475,174,4282,649,1.73103609822562,0.0995077133280035
"22083",13760,701,2238,5462,2498,746,1181,934,10821,2115,2.581866284564,0.140137346319504
"22085",15308,580,1546,7276,3011,943,1339,613,13182,1952,2.94454829411311,0.248842247434602
"22087",28860,1405,3940,8887,7941,2456,2827,1404,23515,4231,5.83028338607142,0.149289489505751
"22089",35287,1112,2168,11356,7764,2849,7704,2334,32007,10038,1.47229691101824,0.0960360819144977
"22091",7523,607,1090,3266,1199,428,568,365,5826,933,1.60217870452183,0.100009379418661
"22093",14131,433,1546,5531,2828,1212,1789,792,12152,2581,1.21661976098845,0.0612479518235017
"22095",28326,883,3043,10965,6522,2376,2850,1687,24400,4537,1.74108138892207,0.099421577989498
"22097",53940,4735,7010,20958,9487,3819,5147,2784,42195,7931,2.82343420600618,0.228787441529503
"22099",35308,2208,3523,16412,5962,1956,3905,1342,29577,5247,3.70595913699928,0.198054345202995
"22101",34244,2203,4280,15934,5289,2373,2803,1362,27761,4165,2.38891042033896,0.166482930356281
"22103",180157,5206,10471,44252,41228,13401,42265,23334,164480,65599,2.63122047898968,0.264010029172667
"22105",86705,5745,9497,31218,16058,5825,12492,5870,71463,18362,2.34047506764701,0.205629179124286
"22107",2964,127,532,1296,538,75,283,113,2305,396,2.66455479281099,0.158545447396083
"22109",73326,5967,7868,27924,14705,4736,7787,4339,59491,12126,4.64195020809296,0.35770135162523
"22111",14886,589,1416,6899,2759,748,1902,573,12881,2475,2.26774631861685,0.22575835238413
"22113",38388,2083,4377,15794,6588,2860,4858,1828,31928,6686,3.47994827908175,0.313468600758974
"22115",30038,977,2622,11896,6636,2331,3983,1593,26439,5576,2.84595904201555,0.328190562078328
"22117",31218,1802,3941,13975,6341,1830,2141,1188,25475,3329,2.10473585506064,0.165110959244641
"22119",25846,1159,2594,11104,5279,1983,2652,1075,22093,3727,2.17731647443555,0.153137041294779
"22121",18699,697,1705,6925,4024,1433,2859,1056,16297,3915,1.39900765436995,0.0495894451750025
"22123",6913,481,850,3314,1225,252,442,349,5582,791,1.69175015648775,0.0898728817061954
"22125",11850,582,1478,4168,2324,594,1979,725,9790,2704,2.28677418728704,0.104097512334815
"22127",9944,573,1238,4624,1568,544,907,490,8133,1397,2.50613155104369,0.236336034856497
"23001",76816,2553,3755,27322,16228,9351,11811,5796,70508,17607,1.97964602320216,0.144857263568498
"23003",49894,1836,2969,18973,10303,5680,6913,3220,45089,10133,8.06755293775207,2.07835850582453
"23005",219290,3638,5865,44666,36460,19434,66136,43091,209787,109227,6.11566088142389,0.275815738513197
"23007",21389,243,1101,7839,4094,2094,3825,2193,20045,6018,4.55560546907782,0.514979822597679
"23009",42378,605,1420,13222,8067,4018,9333,5713,40353,15046,10.9957170242502,0.515314519775891
"23011",89088,2187,3342,30621,17475,8995,16732,9736,83559,26468,2.99371356468085,0.278378335463491
"23013",30824,439,1537,9759,5375,2526,6857,4331,28848,11188,5.32558694330068,0.119093476466375
"23015",26907,462,1174,8609,4223,2330,5938,4171,25271,10109,3.08773761176263,0.150199845593037
"23017",43461,950,2601,17591,7855,5288,6305,2871,39910,9176,5.38208480384499,0.63781267511571
"23019",108593,2199,4809,35630,21402,11966,20056,12531,101585,32587,6.52568919870394,1.05902314815151
"23021",12911,554,559,5043,2607,1529,1898,721,11798,2619,5.99240218053448,1.3129476426615
"23023",27511,515,1108,7851,5005,2510,5972,4550,25888,10522,1.87435041374819,0.0865709092434364
"23025",37532,1049,2326,15546,6677,4473,5500,1961,34157,7461,7.84752390482113,1.22109584337584
"23027",29426,556,1487,9530,5652,2520,5940,3741,27383,9681,3.50109039322843,0.223733558328246
"23029",22798,689,1321,8588,4689,2042,3541,1928,20788,5469,8.82845635969488,0.839417878713987
"23031",156082,2774,5984,46592,32151,17442,32496,18643,147324,51139,2.98252528739412,0.295133143623676
"24001",48094,1015,3667,19630,9498,4584,5749,3951,43412,9700,2.64775809899388,0.116227826416659
"24003",403202,8823,17771,90783,82198,30645,98974,74008,376608,172982,2.222620588867,0.12104505007448
"24005",590247,18380,31197,146153,113461,42423,133305,105328,540670,238633,3.11707717225324,0.168389491571888
"24510",414928,17052,39664,116662,78195,21425,71550,70380,358212,141930,0.780027189192573,0.0233714962475283
"24009",63491,694,2782,18283,13533,5530,12530,10139,60015,22669,1.39207626372552,0.0636099988775334
"24011",22692,1145,2289,8928,4445,1575,2604,1706,19258,4310,1.72614355744872,0.087658549051051
"24013",119909,2016,5429,33819,23045,10071,28032,17497,112464,45529,2.07612216010666,0.122923603568286
"24015",71840,2138,4457,25478,15680,5650,11093,7344,65245,18437,1.89884032132849,0.10226676184048
"24017",111253,2669,4374,33092,26652,9856,20588,14022,104210,34610,2.16486904253568,0.129564457099204
"24019",23268,794,2133,9207,4959,1554,2538,2083,20341,4621,4.31185529727532,0.160052135528775
"24021",182504,5785,7107,43666,33320,15512,43460,33654,169612,77114,2.12022229190881,0.180981582479219
"24023",21496,529,1530,8980,3289,1857,2767,2544,19437,5311,2.07774181466622,0.178481543751518
"24025",180234,3397,7900,47168,38138,15686,39115,28830,168937,67945,2.18580897646326,0.122501829735229
"24027",222846,4993,5314,28642,29814,12419,68260,73404,212539,141664,1.43313563155637,0.0684741662734989
"24029",13803,446,851,4377,2178,778,3033,2140,12506,5173,1.8009485735942,0.0815108941652319
"24031",729167,35878,28060,95734,93376,40215,198678,237226,665229,435904,1.84067382586606,0.13678703647424
"24033",653179,45512,37901,166067,133895,41706,128155,99943,569766,228098,2.14583556673686,0.134021023052491
"24035",35560,598,1938,9890,7186,2804,8032,5112,33024,13144,2.6068029484728,0.1064963056683
"24039",16633,577,2214,6068,3704,1239,1979,852,13842,2831,3.21265567410806,0.0927909668691086
"24037",75240,2138,4130,23515,14709,5894,14303,10551,68972,24854,2.04126077750718,0.10724094565724
"24041",28478,650,1724,6540,5635,2255,6441,5233,26104,11674,2.49979345221661,0.0825310217092038
"24043",107870,3317,9543,39055,23006,8526,14303,10120,95010,24423,3.07665479595433,0.12695660204409
"24045",64993,2471,5486,20614,12538,5158,11133,7593,57036,18726,1.88546014370235,0.102653590603876
"24047",39868,665,2210,11941,9601,3251,7414,4786,36993,12200,2.17108007508771,0.15571144430394
"25001",178120,2705,4981,39626,32949,17929,44199,35731,170434,79930,3.88506275677123,0.123281713073144
"25003",95227,2093,4532,27808,17769,8678,18717,15630,88602,34347,2.51527904612178,0.267882374899289
"25005",404863,28885,28463,122075,69374,37333,76681,42052,347515,118733,2.42045554284537,0.165556590542029
"25007",15556,210,442,3945,2580,1215,4015,3149,14904,7164,1.884276610853,0.0330185360039033
"25009",559879,30094,27337,136493,89505,45842,137282,93326,502448,230608,2.76468737528486,0.151319277283389
"25011",53932,917,2533,15077,8809,5644,11297,9655,50482,20952,2.68918433753561,0.205755304912067
"25013",318636,17324,26859,96780,57079,30688,54293,35613,274453,89906,2.96701614332094,0.178887120243396
"25015",100155,1468,3276,21612,14635,8860,24493,25811,95411,50304,2.94169564805294,0.154278033117505
"25017",1142528,37022,36427,206435,135758,66902,324877,335107,1069079,659984,3.5949600915328,0.240232774370567
"25019",10215,245,143,1863,1960,825,3346,1833,9827,5179,0.930417739978472,0.0157023893308698
"25021",506853,14210,15246,91670,67976,36252,147352,134147,477397,281499,2.4617521091003,0.116279147313798
"25023",369871,11267,14605,98953,63857,35733,90832,54624,343999,145456,3.44866985725656,0.197641752835483
"25025",552886,42203,29606,115175,72819,26907,144811,121365,481077,266176,1.46734304815561,0.0185070609968283
"25027",594147,18838,31284,159573,104541,53800,133744,92367,544025,226111,3.78377925367223,0.44687116129831
"26001",8347,187,612,3167,1988,771,1020,602,7548,1622,1.880261728384,0.204215491334924
"26003",6834,188,387,3181,1399,453,880,346,6259,1226,4.25551605686713,0.284060389653761
"26005",81394,2129,4946,29807,18308,6890,12801,6513,74319,19314,2.10238722581104,0.2393435137466
"26007",21477,382,1188,7783,5570,2945,2299,1310,19907,3609,2.62664728264772,0.175854537779126
"26009",17655,400,814,5486,3908,1752,3387,1908,16441,5295,1.96477245410979,0.155222515758809
"26011",11313,279,988,4363,2740,1321,1091,531,10046,1622,1.80985496014737,0.10694723971544
"26013",6238,156,401,2535,1549,682,575,340,5681,915,3.24921968526217,0.279424505707103
"26015",43590,756,2110,15584,10452,4188,7500,3000,40724,10500,1.63911239416801,0.163928540055495
"26017",75249,1731,4968,25610,19004,8661,10566,4709,68550,15275,2.02356326760566,0.129793769682747
"26019",13574,362,591,3932,2895,1341,2872,1581,12621,4453,1.34296185434762,0.102114189583859
"26021",108057,2898,7076,30270,25733,10756,19128,12196,98083,31324,1.90908721302892,0.163276744233801
"26023",30968,1578,1868,12854,7080,2828,3370,1390,27522,4760,1.55832685061796,0.146058173235744
"26025",91501,2433,5780,32606,22327,8405,12790,7160,83288,19950,1.86460197893429,0.202965061091504
"26027",36957,969,3072,12627,8583,3977,5080,2649,32916,7729,1.54593516476493,0.142918211792413
"26029",19379,248,918,5378,4465,2069,3784,2517,18213,6301,3.31505732750784,0.135157865128975
"26031",19738,322,1509,7075,4494,1864,2669,1805,17907,4474,2.20923958181281,0.236984302147261
"26033",26036,439,1605,8709,6954,2243,3961,2125,23992,6086,7.95033609590692,0.494424256098677
"26035",22557,1049,1995,8880,5725,2188,1664,1056,19513,2720,1.65792589459358,0.167127945882505
"26037",54635,843,1745,13985,13270,6992,11267,6533,52047,17800,1.63895307251162,0.164130341573499
"26039",9942,140,719,3058,2750,1167,1293,815,9083,2108,1.65087152131755,0.165558700354497
"26041",27071,400,1571,9635,6401,3988,3584,1492,25100,5076,5.24892496506572,0.355862731704643
"26043",19045,168,659,6255,4886,2595,3087,1395,18218,4482,2.15556915621924,0.233588661290607
"26045",76997,1265,2647,20296,20874,8623,15200,8092,73085,23292,1.64002470184284,0.164603418176002
"26047",24813,275,871,6260,5755,2480,5293,3879,23667,9172,2.28726952726559,0.143997663484712
"26049",280008,6726,18048,88331,74437,30200,39435,22831,255234,62266,1.81939563308959,0.185794974209998
"26051",18851,815,1385,7342,4718,1913,1648,1030,16651,2678,1.57650759766686,0.1499182022305
"26053",11432,148,520,3866,2700,1721,1668,809,10764,2477,3.92726799585989,0.346622613799476
"26055",68326,909,2396,15170,16286,7312,16152,10101,65021,26253,2.34587526252554,0.14419342137754
"26057",28978,719,1645,11925,7203,2614,3342,1530,26614,4872,1.65089477728056,0.164206481753502
"26059",31337,1138,2074,12643,6968,2766,3428,2320,28125,5748,1.67162218412322,0.170523268792445
"26061",22131,539,1029,6767,4402,1962,4150,3282,20563,7432,3.21373350719923,0.318455775497322
"26063",23300,669,1434,9780,4943,2696,2479,1299,21197,3778,2.79554898710195,0.242408915600852
"26065",175053,3857,7175,37572,39499,15900,38922,32128,164021,71050,1.61322794702873,0.159288927858499
"26067",45718,1146,2733,18501,11195,4794,5344,2005,41839,7349,1.64554975363247,0.165687851504996
"26069",19614,324,1745,7125,5217,2046,1914,1243,17545,3157,1.79384975442413,0.165543490163574
"26071",8923,165,525,3872,1827,820,1107,607,8233,1714,2.87276324470322,0.365707073576692
"26073",36647,932,1810,11547,8193,3107,6142,4916,33905,11058,1.6571881236304,0.166905342482498
"26075",112398,2009,7169,38277,27452,12078,16977,8436,103220,25413,1.87205418757552,0.204405988373001
"26077",164664,2403,6977,37053,36417,15219,40500,26095,155284,66595,1.63536478427498,0.1639385419045
"26079",12923,342,1198,5073,3161,1094,1262,793,11383,2055,1.66583633878703,0.167742436659
"26081",435759,14312,20112,104608,91005,39697,106435,59590,401335,166025,2.00039195578228,0.249426194660502
"26083",1651,38,21,458,325,201,342,266,1592,608,4.83441537218577,0.181780475618724
"26085",9486,394,1317,3847,2082,601,893,352,7775,1245,1.65547536268765,0.166875031654
"26087",63420,1303,3967,23202,16453,6672,8038,3785,58150,11823,1.80750592223246,0.189786742884002
"26089",17329,147,485,3618,3349,1541,4790,3399,16697,8189,2.96349596962506,0.111044564945264
"26091",69179,1612,4299,25545,15983,6622,9822,5296,63268,15118,1.91753253786592,0.213901164978137
"26093",136912,1151,4396,34379,31259,13929,35217,16581,131365,51798,1.65333945817983,0.166336841029006
"26095",4246,76,247,1593,991,579,411,349,3923,760,2.22461834070516,0.281365895088744
"26097",8453,249,474,3033,2018,591,1251,837,7730,2088,6.44019489022461,0.323944129171271
"26099",622955,21454,38403,182867,150023,67311,105604,57293,563098,162897,1.73530164311947,0.137792868020309
"26101",18857,363,1301,6295,4812,1934,2897,1255,17193,4152,1.72261149130692,0.16300481324016
"26103",44338,428,1662,12711,9751,4663,10395,4728,42248,15123,4.08860008019525,0.567069907787786
"26105",21167,403,1014,7418,4705,2696,2938,1993,19750,4931,1.52947720422565,0.148258311478618
"26107",25338,607,1312,9150,5707,2384,3736,2442,23419,6178,1.64588106151084,0.165025682691499
"26109",17490,383,838,7360,3716,2139,2043,1011,16269,3054,3.32558619132201,0.314111003533766
"26111",58656,857,2257,16603,11298,6773,12253,8615,55542,20868,1.59920568590527,0.152567360851997
"26113",10530,266,770,4384,2302,1205,1140,463,9494,1603,1.66359211960892,0.167781282346006
"26115",109148,1926,7350,36909,26047,13291,15008,8617,99872,23625,2.02379483902244,0.15729217330433
"26117",46506,1373,3986,18643,11585,4441,4481,1997,41147,6478,2.14905215569056,0.207121452385003
"26119",7268,178,686,2974,1618,770,680,362,6404,1042,1.66818320743493,0.166397257352002
"26121",120704,3123,6897,41547,29856,14578,17155,7548,110684,24703,1.90617944525351,0.151499022591957
"26123",34774,984,2576,14404,7476,3378,4075,1881,31214,5956,1.99525135880912,0.248621305151997
"26125",903672,16543,31839,164045,173736,75274,250122,192113,855290,442235,2.05557179853477,0.257972163206001
"26127",18581,773,1387,6837,3940,1878,2490,1276,16421,3766,1.56818828129872,0.157774329253142
"26129",15604,364,1651,5957,3794,1764,1368,706,13589,2074,1.66219828280822,0.168061580246003
"26131",4872,67,261,2165,1080,569,516,214,4544,730,3.2665436339776,0.40426854172765
"26133",16145,557,1253,6732,3655,1491,1646,811,14335,2457,1.65090289448153,0.166519224697
"26135",6136,425,672,2234,1520,451,554,280,5039,834,1.66286584343443,0.167994900619492
"26137",17894,322,824,5638,4250,2063,3138,1659,16748,4797,1.66325148365819,0.1555297029505
"26139",184547,3981,7514,48490,40062,18682,43726,22092,173052,65818,1.79645429638079,0.164899300644711
"26141",10189,323,615,3770,2369,1159,1344,609,9251,1953,2.59700320855589,0.203499552255257
"26143",18772,350,1371,6516,5008,2310,1777,1440,17051,3217,1.66086286323695,0.1695360781095
"26145",131476,3255,9174,42795,31932,14967,19027,10326,119047,29353,2.22032593870315,0.234581939554002
"26151",29071,1066,1852,12480,6540,2793,2899,1441,26153,4340,2.22393588627472,0.277442175326973
"26153",6161,163,442,2550,1235,617,716,438,5556,1154,3.07638809904326,0.36883289065106
"26155",48259,913,2927,17298,13043,5283,5988,2807,44419,8795,1.58592417455676,0.154549421913998
"26147",114217,1778,7539,38260,30084,14401,13658,8497,104900,22155,2.57589181385411,0.21328380114389
"26149",41023,2431,2973,14994,9445,4437,4287,2456,35619,6743,1.61976060016438,0.146422107523558
"26157",38474,806,2843,17211,8210,3958,3760,1686,34825,5446,2.17663973180902,0.234452224612288
"26159",52039,2235,3854,16781,12706,5320,7219,3924,45950,11143,1.8341462939744,0.176078945975177
"26161",234731,3138,6905,34379,39946,16108,63229,71026,224688,134255,1.87970063258368,0.204120996174995
"26163",1210140,48602,101357,358049,285789,103923,188024,124396,1060181,312420,2.10506314406993,0.179336181471641
"26165",23293,622,1596,8370,5652,2340,3133,1580,21075,4713,1.66653642154616,0.168137974299505
"27001",12223,226,771,4602,3067,1450,1457,650,11226,2107,3.25952730425594,0.606687533803997
"27003",246455,5193,9242,67611,56356,30960,54908,22185,232020,77093,1.66223142065137,0.132495597775001
"27005",23960,538,1157,6982,5586,3514,4277,1906,22265,6183,2.9324843176488,0.442060759384995
"27007",28331,510,1484,7813,6398,3510,5228,3388,26337,8616,4.6597728318753,0.953337500160014
"27009",27088,568,1790,7809,6589,4140,4430,1762,24730,6192,1.6800273288329,0.123580081079499
"27011",3737,178,123,1444,659,581,474,278,3436,752,2.13191890016223,0.157232058307466
"27013",40338,827,1272,10092,8291,5518,9474,4864,38239,14338,2.3799740459498,0.2226387736985
"27015",17694,402,806,6317,3966,2017,3083,1103,16486,4186,2.44042863320415,0.180414865534997
"27017",25434,484,1089,8281,6127,3367,4020,2066,23861,6086,2.23149261168807,0.266040000046807
"27019",69207,1339,1295,12397,11977,7811,23353,11035,66573,34388,1.69967088674923,0.110778954279495
"27021",21874,340,1055,7093,5597,2484,3704,1601,20479,5305,4.83628554327616,0.738710015394995
"27023",8607,370,416,2890,2040,1235,1176,480,7821,1656,2.4812393208173,0.173842255171507
"27025",39212,373,1459,12787,9658,6162,6355,2418,37380,8773,1.80727036648251,0.131899179338744
"27027",39607,690,1340,8818,8607,5895,9996,4261,37577,14257,3.17235663045002,0.321843208025778
"27029",5795,226,566,2083,1247,648,709,316,5003,1025,2.59619919490918,0.31890330794349
"27031",4394,19,133,1058,865,456,1139,724,4242,1863,4.66427114087087,0.500626459984168
"27033",7814,289,406,2696,1714,971,1276,462,7119,1738,1.90007999324272,0.188481158941009
"27035",47247,580,2258,13821,12081,6279,8191,4037,44409,12228,2.57028641338595,0.350968264911009
"27037",295315,5561,8929,59045,58952,35241,87258,40329,280825,127587,2.01717508356481,0.172482191567416
"27039",13757,124,444,4337,2807,2163,2864,1018,13189,3882,1.43006721801549,0.127807167946505
"27041",27701,401,889,8281,5476,5203,5114,2337,26411,7451,1.95640210706116,0.216377874875995
"27043",9865,254,481,3424,2411,1299,1561,435,9130,1996,1.8947156045319,0.208686390733054
"27045",14491,543,674,4766,3208,2057,2264,979,13274,3243,2.13151310456286,0.249174181459188
"27047",21990,1059,1529,7629,4957,3131,2623,1062,19402,3685,1.89539891861572,0.208820450078517
"27049",33588,492,1390,11271,7202,4291,5930,3012,31706,8942,2.52967214287404,0.228116814648344
"27051",4302,66,242,1404,1081,711,582,216,3994,798,1.71076536596657,0.172870094612502
"27053",883631,28771,25429,138698,155684,76908,287540,170601,829431,458141,2.02981122849869,0.179378631430505
"27055",13397,213,400,4566,2499,2321,2410,988,12784,3398,1.70906813246947,0.164407968195267
"27057",15439,136,726,4465,3593,1964,2976,1579,14577,4555,2.26497026933498,0.306778552696994
"27059",28068,452,1804,9667,7468,3400,3816,1461,25812,5277,1.62072733867803,0.134806694775002
"27061",32556,316,1513,9923,8104,4512,5337,2851,30727,8188,4.83975012362627,0.905456722960502
"27063",7127,131,379,2523,1526,991,1220,357,6617,1577,1.8927629401324,0.207909235654011
"27065",11444,375,765,4272,3046,1289,1101,596,10304,1697,1.77026612050389,0.160343888114002
"27067",29150,1319,1251,7933,6591,4691,5124,2241,26580,7365,2.04670213739337,0.255544570478003
"27069",2981,60,68,1092,718,267,551,225,2853,776,3.1294547635998,0.349718797321434
"27071",9202,191,513,3157,2582,1272,1072,415,8498,1487,4.5930625312891,0.989428738021602
"27073",4909,64,230,1848,1142,671,701,253,4615,954,2.36618456760405,0.229950644315309
"27075",8135,123,413,2553,1707,1222,1398,719,7599,2117,4.18308560081289,0.709271491077657
"27077",2812,3,65,929,800,398,472,145,2744,617,4.23809451177019,0.563841082389392
"27079",19665,315,708,6769,4438,2755,3352,1328,18642,4680,1.84979641868304,0.138548506167003
"27081",3984,74,174,1492,902,505,596,241,3736,837,1.61422993778928,0.160502506088947
"27083",16126,466,660,4725,3679,2264,3210,1122,15000,4332,1.86420250699634,0.211157497824004
"27087",3277,107,337,1198,812,399,299,125,2833,424,1.72839600546806,0.179633001246501
"27089",6318,152,365,2463,1312,809,932,285,5801,1217,4.66345639063003,0.569804328604472
"27091",14284,349,605,5053,3329,1868,2161,919,13330,3080,1.90892887404293,0.210896364670523
"27085",25374,492,1083,8615,6180,4109,3339,1556,23799,4895,1.6817021275881,0.148959850982497
"27093",15817,265,699,5642,3720,2397,2145,949,14853,3094,1.88271101466154,0.190912341429489
"27095",18239,473,1298,6513,4458,2561,2003,933,16468,2936,2.12770063946668,0.204827503753499
"27097",23547,606,1297,9082,5278,3078,2980,1226,21644,4206,3.17418806428274,0.347066729211495
"27099",26749,1402,1436,8689,5579,3317,4310,2016,23911,6326,1.89787708660425,0.205699063480846
"27101",5846,223,355,2116,1255,654,926,317,5268,1243,1.89907980383336,0.209221182964499
"27103",22236,294,824,5412,4619,3257,5165,2665,21118,7830,2.76039475379892,0.136494276126003
"27105",13994,2083,881,4355,2863,1484,1748,580,11030,2328,1.89515413279657,0.208846603171955
"27107",4477,136,215,1561,964,622,779,200,4126,979,2.90590031550418,0.270197548973352
"27109",108832,2532,2950,21345,17936,12755,28523,22791,103350,51314,1.94211267749002,0.190274596985995
"27111",42505,1220,1914,11588,9963,6415,7898,3507,39371,11405,3.49124518143643,0.674069163143005
"27113",9633,153,324,3026,2227,2008,1371,524,9156,1895,2.31360154853476,0.193162769446006
"27115",21421,471,1398,8854,4968,2456,2307,967,19552,3274,2.95510233689288,0.432411468030293
"27117",6252,219,309,2270,1409,770,887,388,5724,1275,1.47243004058087,0.135459661434318
"27119",21079,571,950,6329,4757,2780,4044,1648,19558,5692,5.31359845352744,0.620874924929256
"27121",8165,163,281,2503,1916,1488,1215,599,7721,1814,1.94777259576609,0.214163303118997
"27123",367764,18552,14715,74670,66067,32350,97476,63934,334497,161410,0.977992719092957,0.0502656704429994
"27125",2741,62,89,980,671,454,399,86,2590,485,1.95063046192337,0.134684458409001
"27127",10417,284,457,3916,2627,1141,1493,499,9676,1992,2.52622958854803,0.257974380086004
"27129",10272,282,687,3732,2498,1430,1301,342,9303,1643,2.939272790142,0.290409461410995
"27131",42557,1241,2032,14018,8167,4785,7631,4683,39284,12314,1.66374014090421,0.150862256483503
"27133",6496,180,186,2056,1530,872,1227,445,6130,1672,1.49918595993411,0.139553810445585
"27135",10450,207,482,3788,2595,1287,1681,410,9761,2091,3.62193897000366,0.531742833768622
"27139",96982,2128,2793,19853,18516,12698,28935,12059,92061,40994,1.94832281555636,0.108230745530999
"27141",63235,913,2702,17393,16504,9374,11763,4586,59620,16349,1.82952854404349,0.134320568255
"27143",10364,358,405,3960,2529,1350,1398,364,9601,1762,2.57294992967526,0.176258636176997
"27137",136969,1991,5369,34695,34255,17927,27809,14923,129609,42732,7.05062445470238,2.08878933409849
"27145",97604,4017,3546,26506,21652,13877,18458,9548,90041,28006,3.14824298398945,0.414868999725503
"27147",25176,729,1372,7511,5590,2940,4893,2141,23075,7034,1.41793761317363,0.125687550088497
"27149",5791,181,197,1853,1145,777,1198,440,5413,1638,1.70659676269626,0.171785607203005
"27151",6825,275,335,2266,1466,1057,1149,277,6215,1426,2.24935108985941,0.223406929164497
"27153",17372,1073,1050,6865,3728,2127,1849,680,15249,2529,2.22164566749164,0.294973792138505
"27155",2349,71,83,853,545,448,263,86,2195,349,1.95691580178623,0.175530376580815
"27157",15401,373,487,4989,3253,2175,2807,1317,14541,4124,1.96783016388657,0.160461043385285
"27159",9335,313,558,3236,2313,1356,1216,343,8464,1559,1.75474135289251,0.165164019962509
"27161",13156,330,615,4572,2717,1966,2175,781,12211,2956,1.41877598890497,0.125871136344496
"27163",179100,2404,4298,34884,34386,18735,54621,29772,172398,84393,1.79147080985555,0.125259762733252
"27165",7581,593,379,2748,1710,725,1058,368,6609,1426,1.50201067489029,0.127767582107498
"27167",4516,82,184,1549,897,794,773,237,4250,1010,2.81646139872641,0.227409519668732
"27169",30970,722,1335,7965,6527,4560,6421,3440,28913,9861,2.07660813669583,0.186447041576436
"27171",90705,1293,3654,26034,19228,11596,20566,8334,85758,28900,2.36593142560228,0.211761625646508
"27173",6676,189,326,2227,1634,1088,837,375,6161,1212,3.0498078638428,0.224540367429631
"28001",20961,1200,3060,7089,4017,1837,2089,1669,16701,3758,2.76088866588435,0.119842806060194
"28003",24235,1780,2826,7596,5086,2143,3241,1563,19629,4804,1.39604558847333,0.102551433988119
"28005",9299,218,1140,4019,1979,957,538,448,7941,986,1.80724181982981,0.179249822288761
"28007",12029,712,1552,4175,2749,1265,1118,458,9765,1576,2.26160323176335,0.184278451119497
"28009",5533,613,804,1762,1448,392,237,277,4116,514,1.49149385538615,0.104285866738485
"28011",20382,1381,2617,5030,4019,2145,2904,2286,16384,5190,3.19564655036466,0.228935203774869
"28013",9197,606,1385,3188,1792,1087,700,439,7206,1139,1.61756455748003,0.148458669795501
"28015",7378,472,952,2539,1486,845,801,283,5954,1084,2.01458335483818,0.159391912232501
"28017",11392,958,1713,4039,2048,1211,1073,350,8721,1423,1.61520912820231,0.127342724478502
"28019",5837,267,799,2201,976,510,598,486,4771,1084,1.62707106748027,0.105325148329501
"28021",5064,277,654,1495,1120,441,423,654,4133,1077,2.44047776478916,0.123819811692935
"28023",10880,511,1102,4066,2486,1370,913,432,9267,1345,1.66025771186245,0.171481258621575
"28025",12901,650,1486,4375,2273,1579,1636,902,10765,2538,1.88330888153458,0.104741256374495
"28027",13753,1107,1477,3415,3388,1834,1703,829,11169,2532,2.53645791787969,0.147771341555411
"28029",18650,993,2030,6050,3882,2303,2554,838,15627,3392,2.12401458008841,0.192369350840498
"28031",12170,535,1388,3876,2986,1467,1357,561,10247,1918,1.39001828975152,0.102164353424003
"28033",120275,3291,7417,35150,29293,13744,20412,10968,109567,31380,2.05690172394702,0.126581573465084
"28035",48525,1463,3875,12421,11704,5019,7909,6134,43187,14043,1.67644461807842,0.115216640138995
"28037",5361,348,527,1623,1386,626,621,230,4486,851,1.65661683428669,0.139352086060001
"28039",15913,624,1792,5486,3852,1987,1420,752,13497,2172,1.45976131556354,0.118145652142206
"28041",9848,778,1444,3492,2382,685,654,413,7626,1067,1.68380335071054,0.176230485047385
"28043",14925,601,2078,4521,3060,1618,1800,1247,12246,3047,1.69836897413533,0.113340575239499
"28045",33141,1149,2528,9823,8198,3456,4755,3232,29464,7987,1.67411278020824,0.118030090088386
"28047",138227,4090,11075,39204,32627,17409,21110,12712,123062,33822,2.10976298793984,0.143271752195374
"28049",150056,5645,12201,34347,36206,15341,26462,19854,132210,46316,2.88849526236237,0.217504449993501
"28051",10941,1046,1407,3874,2651,578,1006,379,8488,1385,2.48989462497205,0.191364025312496
"28053",5177,370,857,1541,901,569,468,471,3950,939,2.09397432935875,0.107861559163505
"28055",939,107,273,357,115,45,15,27,559,42,2.86229669053962,0.109996275595815
"28057",16084,906,1740,5644,4001,1429,1273,1091,13438,2364,1.48382319117215,0.137039163253807
"28059",98135,3888,7186,27711,24665,12155,14836,7694,87061,22530,2.49685645810063,0.1818282568655
"28061",11246,365,1104,4765,2363,969,1139,541,9777,1680,1.63840823263238,0.167514444686508
"28063",4885,360,692,1613,1153,185,506,376,3833,882,1.99033325450835,0.129993427218024
"28065",8004,327,923,3247,1653,744,551,559,6754,1110,1.51012832368134,0.100656391058495
"28067",44307,2789,3393,14147,9990,4915,5424,3649,38125,9073,1.66846787767571,0.172264636654507
"28069",5962,342,756,2129,1180,720,474,361,4864,835,1.79540830064647,0.191144130831216
"28071",32559,790,2078,6542,5457,3047,7894,6751,29691,14645,1.86011231465088,0.172435070780999
"28073",42686,1670,2771,10907,9372,3976,9095,4895,38245,13990,1.54098917682115,0.122556581317003
"28075",49896,2121,5563,13382,11914,6603,6627,3686,42212,10313,1.71425073714619,0.177524932558015
"28077",8150,625,865,3137,1393,911,555,664,6660,1219,1.42161020065381,0.107173560655502
"28079",14071,843,1818,4995,2937,1167,1416,895,11410,2311,1.53241036126609,0.145870167135004
"28081",55501,2092,5540,14408,11923,5856,9599,6083,47869,15682,1.43600859630943,0.114928207666503
"28083",17696,1321,1769,6396,3491,1397,1672,1650,14606,3322,2.40202411488447,0.152477766591999
"28085",23844,1008,2469,8994,4890,2623,2255,1605,20367,3860,1.74140715634786,0.144723041524005
"28087",39120,1521,3512,12887,7874,3492,6040,3794,34087,9834,1.94894927270958,0.129726769338415
"28089",72023,1615,3995,12197,12650,5389,20785,15392,66413,36177,2.69766309098876,0.184673671763995
"28091",16808,1164,1585,6286,3753,2121,1276,623,14059,1899,1.65618254118841,0.134518705239223
"28093",23703,1333,3198,9044,5713,1367,2031,1017,19172,3048,2.07518610125753,0.181024293001949
"28095",23964,1543,2461,9277,4406,2273,2599,1405,19960,4004,1.98375128744253,0.194874591888462
"28097",6921,313,1232,1886,1574,660,786,470,5376,1256,1.63863891981848,0.1024289101215
"28099",18327,1023,2438,6029,4441,2020,1298,1078,14866,2376,1.53355286989448,0.142458303878002
"28101",13943,600,1613,4703,2915,2069,1398,645,11730,2043,1.52303081343248,0.143878409438499
"28103",6787,655,891,2659,928,827,642,185,5241,827,1.69591922945306,0.175181518110656
"28105",26840,825,1633,5696,4377,2481,5784,6044,24382,11828,1.40508853955343,0.115969980872496
"28107",22193,1588,2816,7026,4185,3045,2304,1229,17789,3533,1.7330243956752,0.178942755932002
"28109",38352,1968,3459,13534,9499,4337,3638,1917,32925,5555,2.51261590104492,0.199798309491642
"28111",7970,439,782,3523,1736,721,452,317,6749,769,1.66970885616162,0.159327201371496
"28113",26038,1030,3305,9673,4903,2882,2418,1827,21703,4245,1.27541879642997,0.100652081640185
"28115",20420,1478,2847,5834,4953,1796,2218,1294,16095,3512,1.45095884901765,0.126957074759501
"28117",16911,791,1947,5662,3354,2323,1760,1074,14173,2834,1.39670598930856,0.106480469956501
"28119",4307,357,737,1472,892,365,290,194,3213,484,1.48500308817119,0.103042633301504
"28121",108076,3423,7595,25766,25447,11823,21987,12035,97058,34022,2.44440971923236,0.1998194245885
"28123",17942,1961,2018,6069,4554,1150,1434,756,13963,2190,1.69234939013923,0.151548088376502
"28125",2705,205,341,1052,474,173,320,140,2159,460,1.75622278941768,0.108597216356998
"28127",17793,930,2732,5360,3885,2033,2103,750,14131,2853,1.91979690591448,0.145829399063997
"28129",9963,729,1143,3759,2000,855,805,672,8091,1477,1.6859128208355,0.157557565710496
"28131",12166,531,1364,4008,2948,1509,1008,798,10271,1806,1.43784157099385,0.109375391730503
"28133",17878,1224,3063,6072,3395,1250,1603,1271,13591,2874,2.06052062489375,0.177898085781002
"28135",9022,704,1272,3216,1640,1084,634,472,7046,1106,2.24392052964808,0.164680371864995
"28137",18468,839,1800,6129,4194,2017,1868,1621,15829,3489,1.93047156325736,0.104667643643497
"28139",14418,980,2209,4683,2913,1498,1457,678,11229,2135,1.53570111013591,0.117276390320508
"28141",13385,1279,1544,4481,2702,1665,1036,678,10562,1714,1.48797831616649,0.113313528540672
"28143",6477,311,722,2604,1190,629,684,337,5444,1021,2.41037359564208,0.121260347845294
"28145",18486,1239,2778,5646,3709,2075,2178,861,14469,3039,1.48429338521466,0.105966451019002
"28147",9184,638,1036,3492,1548,816,944,710,7510,1654,1.56102910374654,0.0990792908011831
"28149",30652,1054,2633,8715,6913,3907,4653,2777,26965,7430,4.11864251807736,0.153519628301622
"28151",29913,2159,3528,9452,5884,2722,3823,2345,24226,6168,3.11822023372152,0.190631104508949
"28153",12807,1058,1381,4624,2534,516,1385,1309,10368,2694,1.8226925638373,0.200320282970514
"28155",6656,270,745,2377,1210,879,760,415,5641,1175,1.54116700869521,0.106510560302999
"28157",6357,362,824,2778,953,585,494,361,5171,855,2.1004807807362,0.16848683497532
"28159",12398,609,1166,4482,2979,1197,1305,660,10623,1965,1.74425578431969,0.152601674913505
"28161",9007,498,829,4165,1706,782,620,407,7680,1027,1.49404101160862,0.125142460970004
"28163",19710,1715,3022,7128,4221,1301,1702,621,14973,2323,2.98946992705955,0.232877290277502
"29001",13692,366,743,4610,2381,1076,2076,2440,12583,4516,1.63724213726171,0.155964233993993
"29003",12517,278,535,4713,2771,806,2087,1327,11704,3414,1.71393172407194,0.119135494146267
"29005",3887,109,278,1688,830,179,574,229,3500,803,1.95898017141718,0.151199159410172
"29007",17452,784,1436,7418,3492,1680,1761,881,15232,2642,2.33924092758443,0.188220323968995
"29009",24371,930,2699,10080,5021,2007,2544,1090,20742,3634,1.84511398641485,0.20662141575885
"29011",8032,295,695,3266,1500,709,1069,498,7042,1567,1.66122350268905,0.157476154191474
"29013",11062,379,942,5329,2023,842,1044,503,9741,1547,2.29514965195431,0.22699560014497
"29015",14969,629,1324,6065,3419,1395,1113,1024,13016,2137,1.87616093016035,0.2007106177075
"29017",7721,356,812,3699,1522,412,573,347,6553,920,1.84316506542117,0.163551996522002
"29019",110816,2159,3383,23120,20202,8200,30021,23731,105274,53752,2.20298558992065,0.186102639109499
"29021",58026,1985,4094,22170,13115,3818,8913,3931,51947,12844,1.69627797545104,0.112893177669039
"29023",29253,1195,3430,11641,6678,2475,2376,1458,24628,3834,2.35642094719714,0.182635746006189
"29025",6007,212,435,2697,1248,517,631,267,5360,898,1.41826676263156,0.116822406870998
"29027",30608,678,2643,11086,6311,2537,4863,2490,27287,7353,2.24404183875985,0.227682409033001
"29029",32646,500,2317,11953,7862,2700,5033,2281,29829,7314,2.43000304683711,0.188324837073
"29031",52214,1294,2956,16792,11268,2802,10926,6176,47964,17102,1.95553690484028,0.154504653694684
"29033",5981,143,433,2674,1112,444,773,402,5405,1175,2.54190827703927,0.190036090019003
"29035",3667,84,394,1910,528,268,293,190,3189,483,1.68604164838206,0.133367853396499
"29037",73193,1760,3124,23709,18146,6531,13579,6344,68309,19923,2.0149660306978,0.188289994285479
"29039",9821,425,934,3857,2224,865,885,631,8462,1516,1.56199280875489,0.131982456495498
"29041",5226,109,343,2430,965,373,639,367,4774,1006,2.40682713396034,0.207982352604999
"29043",59218,1036,3407,17079,13583,5479,11527,7107,54775,18634,1.96603452742743,0.147749382214998
"29045",4573,139,482,2053,828,508,369,194,3952,563,1.69499114737928,0.140662712425362
"29047",169909,3452,7505,46008,39849,15055,38403,19637,158952,58040,1.53485848571499,0.110544552994996
"29049",14636,174,800,6330,2908,1310,2165,949,13662,3114,1.3693125168408,0.115013692216
"29051",53525,1022,2959,15884,10995,3766,12356,6543,49544,18899,1.73198332328995,0.106722173685002
"29053",11841,374,894,4517,2180,1120,1844,912,10573,2756,1.64397818666201,0.152944454847994
"29055",16267,1079,1995,6365,3417,1459,1375,577,13193,1952,1.9042411570335,0.197546928080497
"29057",5495,165,427,2400,1325,418,646,114,4903,760,1.49976793937208,0.133462386747502
"29059",11685,577,961,5666,2504,453,821,703,10147,1524,1.65792039993331,0.143609193134
"29061",5595,330,388,2286,1045,426,743,377,4877,1120,1.61202893842682,0.155336955282003
"29063",8556,266,626,3965,1749,638,876,436,7664,1312,1.37940466369015,0.116139293084999
"29065",10273,535,1124,4246,2082,684,995,607,8614,1602,2.25308487422755,0.19941488266701
"29067",8470,346,1030,3431,2050,495,746,372,7094,1118,2.15239051594243,0.213401231778499
"29069",18906,1383,2549,7676,3010,1666,1505,1117,14974,2622,2.56244259770618,0.142160787849722
"29071",72477,2043,5243,24440,17115,8315,9618,5703,65191,15321,2.27890726597617,0.248628403997496
"29073",10734,468,783,4298,2250,992,1246,697,9483,1943,1.68983908102102,0.140544780699
"29075",4246,251,342,1783,729,298,542,301,3653,843,1.47060191000984,0.134700792051501
"29077",194614,4550,9270,54625,48710,15483,39209,22767,180794,61976,1.78243962236105,0.178333882663492
"29079",6622,433,597,2461,1338,717,766,310,5592,1076,1.40594268529255,0.119853400791002
"29081",5645,124,364,2575,1022,621,602,337,5157,939,1.81769161864651,0.199437227750193
"29083",15631,466,1317,6663,3462,1275,1492,956,13848,2448,1.85558209083234,0.1955679382145
"29085",6505,225,482,3115,1498,545,387,253,5798,640,1.51638647210183,0.109297472970003
"29087",3149,34,150,1469,657,182,418,239,2965,657,2.15585842822804,0.128666428878638
"29089",6598,307,491,2255,1284,432,962,867,5800,1829,1.52464894372891,0.127236834835002
"29091",27156,1013,2830,10653,5683,2034,2986,1957,23313,4943,2.02528215345097,0.242726051054804
"29093",6910,542,655,2714,1354,570,726,349,5713,1075,2.20199063554984,0.145789470937496
"29095",486192,13072,28905,136438,112433,37832,99225,58287,444215,157512,1.78289390211939,0.166030243226102
"29097",80462,3117,6850,27173,18172,5892,13549,5709,70495,19258,1.73491136239997,0.168608866296792
"29099",156935,3193,11339,49883,37877,19961,22993,11689,142403,34682,2.07383183237991,0.177132001678664
"29101",31622,772,1456,9840,7205,3131,5216,4002,29394,9218,1.99685943361909,0.223566216364004
"29103",2466,159,169,1120,424,215,237,142,2138,379,1.50029496991223,0.138698885145496
"29105",24218,899,2364,10256,4875,1785,2775,1264,20955,4039,2.08659573682319,0.203087460019997
"29107",22768,603,1578,9885,4369,1444,2933,1956,20587,4889,2.15317279134129,0.172213909768996
"29109",25226,1137,2640,9885,6284,1419,2812,1049,21449,3861,1.61702949466092,0.161059859632005
"29111",6587,235,727,2979,1395,413,519,319,5625,838,1.619111389295,0.139734821483199
"29113",39297,737,2859,15996,8333,4002,5494,1876,35701,7370,2.06842614120989,0.172641673426023
"29115",8206,245,583,3776,1339,697,1029,537,7378,1566,1.69096002483559,0.169381029493004
"29117",10520,360,878,4355,1846,979,1321,781,9282,2102,1.77991498168399,0.146631678195999
"29121",10451,275,735,4756,2017,813,1261,594,9441,1855,1.97963700214235,0.221434435166009
"29123",8748,341,750,3643,1808,832,855,519,7657,1374,1.46340872065604,0.131292520898501
"29125",6065,290,567,2371,1133,671,643,390,5208,1033,1.68778070185782,0.141096925440001
"29127",19249,515,1484,7041,3982,1550,2815,1862,17250,4677,1.61955928792919,0.120949340056699
"29119",15558,1459,1938,6768,2665,1028,1190,510,12161,1700,1.60954066407706,0.140807190488637
"29129",2439,59,246,1042,471,173,301,147,2134,448,1.44132860046633,0.125085611816074
"29131",16994,503,1366,6666,3658,1457,2285,1059,15125,3344,1.84091143651574,0.159882642520003
"29133",9158,611,1238,4303,1314,469,815,408,7309,1223,1.93353014033264,0.112225347371053
"29135",10563,714,809,4475,2035,597,1359,574,9040,1933,1.58993689509342,0.112238598331005
"29137",6091,189,368,2966,1199,406,768,195,5534,963,1.81621653209526,0.181722414788999
"29139",8010,320,814,3507,1422,634,897,416,6876,1313,1.6645487127073,0.145435513675499
"29141",14684,1706,1361,5913,2673,1106,1231,694,11617,1925,1.90703660120489,0.164046135430003
"29143",11491,583,1453,5223,1709,948,829,746,9455,1575,2.67008707414288,0.181785473711007
"29145",39862,1586,2702,13968,9184,3443,6088,2891,35574,8979,1.70068492583933,0.164092918263075
"29147",12055,302,427,4654,2491,923,2008,1250,11326,3258,2.19546039794601,0.241078272485848
"29149",6234,419,618,2733,1234,343,446,441,5197,887,1.88621608682064,0.20669950160367
"29151",9118,336,407,3821,1400,1173,1492,489,8375,1981,1.92580639916553,0.163984521351498
"29153",6505,413,787,2655,1462,416,487,285,5305,772,1.90858018676249,0.197120088061425
"29155",10486,906,1212,4804,1770,563,722,509,8368,1231,1.92346716534319,0.133299992740446
"29157",13050,713,1088,5319,2430,988,1788,724,11249,2512,1.93768123943505,0.128136730050877
"29159",28360,1350,2226,9988,6459,3159,3012,2166,24784,5178,1.75763286337983,0.184155432197503
"29161",27965,771,1858,8411,5872,2324,4699,4030,25336,8729,2.09729742122203,0.178819209378002
"29163",12493,309,1308,6468,1929,621,1224,634,10876,1858,2.04118507154125,0.185303357164289
"29165",72023,604,1824,15714,16561,5360,19598,12362,69595,31960,1.6804388943806,0.115517479821765
"29167",20355,655,1535,7620,4756,1384,2905,1500,18165,4405,1.72357089185535,0.1698039846735
"29169",29963,577,1090,8972,6963,3647,5294,3420,28296,8714,1.54616606198051,0.146176540844001
"29171",3420,95,97,1404,865,320,392,247,3228,639,2.26148107601805,0.142939454889737
"29173",7323,313,386,3594,1442,527,706,355,6624,1061,1.67218315087395,0.131291985069134
"29175",17115,503,1381,6574,3727,1813,2055,1062,15231,3117,1.44688602652328,0.132180409923494
"29177",16121,387,1326,7353,3520,1046,1734,755,14408,2489,1.79667023839959,0.1553890275225
"29179",4573,286,728,1738,876,319,495,131,3559,626,2.2914212054455,0.214571514872998
"29181",7681,377,1023,3131,1768,588,539,255,6281,794,1.74101083190036,0.164854043924991
"29195",15183,803,1157,5822,2771,922,2481,1227,13223,3708,2.23609744971393,0.2069264355825
"29197",2714,85,195,1322,404,445,204,59,2434,263,1.61892810527266,0.0847468065338389
"29199",2985,422,192,1223,534,178,290,146,2371,436,1.4079207825609,0.120808708351971
"29201",25928,1311,2428,9829,5393,1706,3442,1819,22189,5261,1.70848125206019,0.111747546195608
"29203",5161,176,559,2396,849,393,435,353,4426,788,2.36403606238324,0.263783670442506
"29205",4194,110,364,1774,841,311,528,266,3720,794,1.59474281622326,0.136820235712503
"29183",275283,3347,9371,63606,58940,24973,73334,41712,262565,115046,2.64511062973499,0.159063188686184
"29185",6785,131,678,2837,1630,601,633,275,5976,908,1.90200801467651,0.186595934761999
"29187",47647,2127,4556,18093,11698,4224,3855,3094,40964,6949,2.03378573572799,0.120470224201496
"29189",695526,12269,28784,146718,139067,53672,178586,136430,654473,315016,2.25377405997811,0.140205054421161
"29510",218427,6806,16682,53352,44449,14119,46496,36523,194939,83019,0.652370696599024,0.0177403300212666
"29186",13142,396,734,4927,3067,1516,1547,955,12012,2502,1.75274175150588,0.134462904573768
"29207",20112,1280,2524,8741,3482,1343,1909,833,16308,2742,2.50370391387508,0.216918521842001
"29209",24063,610,1784,8150,6164,2374,3322,1659,21669,4981,1.61096703049423,0.133490597331382
"29211",4128,297,320,1986,638,263,403,221,3511,624,1.72084861793901,0.178508348308505
"29213",38764,913,2936,13331,9709,3227,6008,2640,34915,8648,1.71153568828307,0.170078436732662
"29215",17669,658,1968,7101,4174,1149,1490,1129,15043,2619,2.30314810872008,0.3104305000145
"29217",13227,560,850,5320,2681,1293,1533,990,11817,2523,2.09522713512715,0.221870107395371
"29219",24241,872,2048,9183,5434,1955,3279,1470,21321,4749,1.72002581245908,0.117539346992002
"29221",16535,912,2314,6687,3302,1233,1333,754,13309,2087,1.83181125967004,0.202443151118505
"29223",8257,368,1137,3548,1790,528,545,341,6752,886,2.12524528136553,0.2032472398475
"29225",25219,1391,1807,9724,5401,2272,3041,1583,22021,4624,1.62239188786509,0.156265515609501
"29227",1406,24,97,693,223,111,172,86,1285,258,1.20679887210529,0.0733844352498252
"29229",12124,738,1327,5193,2320,1131,957,458,10059,1415,1.71825416304827,0.1797501871015
"30001",6368,106,242,1787,1516,607,1439,671,6020,2110,8.90819683104394,1.65097710465271
"30003",7440,131,658,2521,1865,818,899,548,6651,1447,7.54714093215877,1.49364542494578
"30005",4229,98,296,1127,1033,631,759,285,3835,1044,5.52887133903556,1.33418229828886
"30007",4738,111,225,1257,1286,744,781,334,4402,1115,3.51431240502117,0.374673571806997
"30009",8038,129,232,2433,2064,645,1596,939,7677,2535,4.92045536444208,0.611709067766965
"30011",1027,17,62,320,305,109,173,41,948,214,4.27003018677603,0.998517261441806
"30013",57614,1388,2670,18023,13733,5827,10327,5646,53556,15973,5.58060137854618,0.835366270720494
"30015",4102,97,228,1427,835,395,868,252,3777,1120,6.11364573010881,1.244678344069
"30017",8557,149,358,2544,2070,1043,1584,809,8050,2393,5.25185280275179,1.1462131238
"30019",1301,19,73,460,307,152,208,82,1209,290,3.22955792151319,0.452039620795929
"30021",6539,92,236,1976,1244,1475,981,535,6211,1516,4.1056835799856,0.733635899244495
"30023",7380,130,555,2770,1773,491,1264,397,6695,1661,2.94149753762623,0.223212780469502
"30025",2082,25,69,713,516,359,328,72,1988,400,3.33038422713962,0.491115147566134
"30027",8526,143,256,2739,2195,943,1779,471,8127,2250,6.91869612936645,1.33907632253299
"30029",73763,780,2949,20566,17324,7323,16527,8294,70034,24821,8.80558972478283,1.64998408547476
"30031",75145,624,1295,13764,15543,4683,24890,14346,73226,39236,5.49143444334479,0.785799051974753
"30033",670,7,9,279,161,70,111,33,654,144,7.35610646903088,1.4930611132315
"30035",8435,155,810,3135,1622,882,1188,643,7470,1831,5.46836451236111,0.961048160921257
"30037",628,14,39,234,180,40,89,32,575,121,3.16601345244116,0.355985776054997
"30039",2487,34,191,702,488,257,614,201,2262,815,3.76533965231432,0.525112670482495
"30041",10104,141,752,3042,2572,962,2031,604,9211,2635,4.56323752237453,0.921512634047962
"30043",8768,151,329,2331,1787,1033,2041,1096,8288,3137,3.70239798344449,0.500481198803999
"30045",1422,29,43,423,348,249,284,46,1350,330,3.86006286691956,0.573449401713511
"30047",21431,542,1102,5412,5137,2263,4775,2200,19787,6975,4.58981294022586,0.512827393645001
"30049",49550,463,1701,11523,10374,4546,13132,7811,47386,20943,6.93351586138576,1.073774215648
"30051",1410,257,129,281,302,121,235,85,1024,320,3.06372552675546,0.456538785596012
"30053",15172,431,857,5771,3939,1274,2076,824,13884,2900,5.68313606281179,1.15918787952831
"30057",6742,55,188,1890,1560,897,1522,630,6499,2152,4.95427056358132,1.07073932788746
"30055",1347,11,42,426,446,177,189,56,1294,245,4.8532025547856,0.831576426421501
"30059",1427,13,39,477,397,79,330,92,1375,422,4.95050923631345,0.728142784944009
"30061",3421,66,189,1158,843,308,661,196,3166,857,4.2236012639517,0.375720271590713
"30063",79823,1098,1820,16601,17853,7156,22249,13046,76905,35295,6.1707958397588,0.802488381311506
"30065",3635,53,261,1274,964,325,524,234,3321,758,3.91822698948124,0.568158200148503
"30067",13231,102,351,3586,3412,1375,3110,1295,12778,4405,4.92065604096916,0.838615947730844
"30069",332,0,2,137,77,22,76,18,330,94,4.84625289336012,0.513997719974004
"30071",3014,41,182,1059,928,230,412,162,2791,574,6.89820576132392,1.63500592773631
"30073",4103,195,160,1200,1111,506,738,193,3748,931,5.00595621921259,0.514936034083
"30075",1298,12,68,418,361,114,218,107,1218,325,4.17794430093145,0.981764816181781
"30077",5419,94,438,2293,1189,387,674,344,4887,1018,5.11681735882145,0.712503154275497
"30079",912,38,81,263,184,112,153,81,793,234,4.42337772948951,0.532433232200488
"30081",32784,526,1899,9763,7834,3457,5710,3595,30359,9305,5.4351956055363,0.723093102077957
"30083",7542,51,297,2928,2186,855,934,291,7194,1225,4.2779173133903,0.653901533090013
"30085",6230,123,475,2021,1690,711,843,367,5632,1210,5.42707653191997,0.743798135475805
"30087",5282,152,404,1740,1347,619,626,394,4726,1020,7.4714563743435,1.517766809254
"30089",9465,212,637,3703,2209,908,1442,354,8616,1796,6.75153168700667,0.86542432302812
"30091",2541,80,108,890,669,141,458,195,2353,653,3.24054465577722,0.540102768994885
"30093",24090,434,1069,8313,5547,1989,4483,2255,22587,6738,2.83481638880655,0.215773774255998
"30095",6436,116,353,2062,1606,500,1290,509,5967,1799,4.37196447198189,0.540035607519006
"30097",2587,7,95,842,793,278,437,135,2485,572,3.86456278173873,0.558305195237485
"30099",4174,127,188,1436,1098,274,776,275,3859,1051,4.85438359608948,0.712796943629013
"30101",3568,141,235,1259,796,204,581,352,3192,933,3.4890488583727,0.615046376755316
"30103",549,12,37,184,118,37,147,14,500,161,2.96820724976514,0.297279662555499
"30105",5311,22,350,1766,1527,633,837,176,4939,1013,6.46092830421084,1.59103778913345
"30107",1555,39,108,611,395,125,213,64,1408,277,2.8203530514355,0.43311440828352
"30109",720,34,19,280,118,95,131,43,667,174,2.91145109685411,0.27249803672508
"30111",111998,1520,4062,31356,26693,10654,26082,11631,106416,37713,5.11954212215378,0.795937313818
"31001",20373,588,1129,5533,5353,2504,3225,2041,18656,5266,1.58877161769385,0.1553027555945
"31003",4324,92,240,1543,968,685,545,251,3992,796,1.97676424501363,0.242308002921495
"31005",320,2,12,77,86,53,62,28,306,90,1.85169421397604,0.200788412912503
"31007",469,27,7,84,152,71,82,46,435,128,1.97373070636141,0.20849164771356
"31009",289,0,23,105,54,41,51,15,266,66,1.85150592389526,0.200663932604003
"31011",3748,67,127,1507,785,530,503,229,3554,732,1.79776695884858,0.192546757610501
"31013",7466,288,419,2404,2245,711,1112,287,6759,1399,2.35190962194005,0.304426565294006
"31015",1360,18,49,592,292,180,152,77,1293,229,2.34470680777163,0.155470043424454
"31017",2046,22,106,755,441,262,316,144,1918,460,2.5413310375929,0.347163895305999
"31019",30804,938,1435,7597,7308,2890,6997,3639,28431,10636,2.16648375723207,0.2697882261955
"31021",4710,94,327,1707,982,512,842,246,4289,1088,1.77899377293169,0.139564677557936
"31023",5740,121,238,2116,1102,796,1076,291,5381,1367,1.71294090613776,0.164340026671504
"31025",18232,307,730,5208,4171,2389,3514,1913,17195,5427,1.86998738586539,0.1566478874167
"31027",5620,121,200,2099,1167,811,871,351,5299,1222,1.91713310795772,0.211912262956507
"31029",2570,138,173,674,787,222,414,162,2259,576,2.11094484634509,0.246993073656981
"31031",3805,27,77,1223,947,549,702,280,3701,982,5.64973031794237,1.70575007777734
"31033",6665,97,320,2232,1604,907,1127,378,6248,1505,2.41785424680593,0.332672397472185
"31035",4183,125,169,1487,905,659,591,247,3889,838,1.60330013408221,0.157864193016997
"31037",6485,1059,664,1938,1195,648,763,218,4762,981,1.36077117300455,0.116451141482999
"31039",6155,329,325,2114,1214,720,1069,384,5501,1453,1.62418349807783,0.161524150557006
"31041",7337,142,267,2380,1911,916,1247,474,6928,1721,3.4813482003658,0.718291268281003
"31043",12938,1632,1223,4336,2744,1219,1326,458,10083,1784,1.23759561968356,0.0757135483039637
"31045",5092,49,210,1055,1405,518,971,884,4833,1855,2.58564555319851,0.398810482068774
"31047",15550,2198,1266,4811,3357,1408,1848,662,12086,2510,2.3460501096964,0.282023961141498
"31049",1373,68,63,405,389,180,196,72,1242,268,1.57653857744549,0.122364178012961
"31051",3780,302,287,1231,708,449,598,205,3191,803,1.73207330362032,0.136926205882297
"31053",24730,1194,1467,8946,5540,2702,3126,1755,22069,4881,1.82172043130694,0.151829889957003
"31055",377676,16423,16834,78693,81267,30574,98476,55409,344419,153885,1.62625608080354,0.0945681963252567
"31057",1306,27,96,297,337,152,246,151,1183,397,2.15002873879556,0.252272373924813
"31059",4071,86,143,1454,897,588,581,322,3842,903,1.60809162898511,0.158693310657999
"31061",2155,46,120,786,533,315,238,117,1989,355,1.60228913855545,0.157751580474008
"31063",1707,40,59,476,453,260,322,97,1608,419,2.29299899378228,0.269785829114501
"31065",3286,105,210,1026,851,405,478,211,2971,689,1.83054595356938,0.197387342693795
"31067",15183,470,912,5591,3158,1980,2250,822,13801,3072,1.94894813054716,0.235841489245668
"31069",1328,24,58,428,315,151,239,113,1246,352,2.94818615297411,0.48423552323599
"31071",1381,9,36,346,413,171,330,76,1336,406,1.61994472665831,0.1606159538495
"31073",1416,4,81,366,323,203,320,119,1331,439,1.59130999182372,0.1273320953285
"31075",467,8,25,137,130,35,105,27,434,132,1.9834931314916,0.220145270850998
"31077",1548,72,56,557,388,220,191,64,1420,255,1.61512824508901,0.159527988517503
"31079",40219,3141,2932,12541,9508,3356,5791,2950,34146,8741,1.57625822991053,0.152774198529
"31081",6435,52,160,1778,1849,901,1134,561,6223,1695,1.67389732353115,0.150706086310001
"31083",2226,52,107,606,488,409,417,147,2067,564,1.59825548138862,0.157210935304782
"31085",638,7,35,192,175,109,108,12,596,120,1.83193369720773,0.196371416306499
"31087",1835,15,77,567,624,217,220,115,1743,335,1.82551485516261,0.196750629752233
"31089",6939,180,264,2093,1576,1002,1303,521,6495,1824,3.37551483480133,0.685231458805505
"31091",473,17,17,181,91,42,115,10,439,125,1.86094198379615,0.202751663407508
"31093",4457,92,117,1777,1062,510,731,168,4248,899,1.61459604016755,0.160079429156004
"31095",5208,169,264,2010,1144,739,691,191,4775,882,1.60237103003869,0.157690614136138
"31097",3794,144,293,1710,638,301,471,237,3357,708,1.31676496462273,0.103505328399499
"31099",4442,156,74,1286,1175,555,954,242,4212,1196,1.5751814215197,0.142084259272
"31101",6080,301,331,1749,1759,714,851,375,5448,1226,2.39367647512314,0.308610334703996
"31103",618,16,13,187,152,78,126,46,589,172,2.336114783899,0.220914319039444
"31105",2562,91,218,982,664,281,212,114,2253,326,2.13692020851092,0.264789127249165
"31107",5761,139,300,2057,1308,872,730,355,5322,1085,2.61078444171792,0.324018193409129
"31109",199635,5633,7684,41872,41374,22977,50485,29610,186318,80095,1.9431100729033,0.233868726533497
"31111",24217,513,962,7331,6802,3445,3362,1802,22742,5164,3.48342741390223,0.714410437994996
"31113",565,9,14,139,156,98,133,16,542,149,1.61525076443895,0.159702801567491
"31115",477,2,6,181,127,75,59,27,469,86,1.62231187481761,0.160506956672001
"31119",23117,1025,803,7263,4891,3526,3904,1705,21289,5609,1.62561478017944,0.161731457137998
"31117",373,5,21,107,61,90,72,17,347,89,2.08320588331577,0.240585729712507
"31121",5433,153,219,2036,1490,647,603,285,5061,888,2.4260031063103,0.138073136265997
"31123",3138,91,203,1075,817,337,452,163,2844,615,2.58804191925437,0.400786433614001
"31125",2361,61,103,792,622,358,258,167,2197,425,1.69648366660071,0.124990790810005
"31127",4578,139,280,1317,1051,446,950,395,4159,1345,1.69431978106566,0.112502363710859
"31129",3014,46,191,983,722,389,460,223,2777,683,1.60176035808683,0.157687015637968
"31131",10873,271,492,3635,2365,1244,1932,934,10110,2866,2.082760916372,0.170688058741716
"31133",1814,141,127,714,360,181,171,120,1546,291,1.42884197570333,0.118551909241389
"31135",1965,98,109,472,636,175,420,55,1758,475,2.21829887742737,0.244564861510222
"31137",6163,102,388,1744,1641,697,1092,499,5673,1591,1.58494334501641,0.148736998802499
"31139",4911,142,134,1672,929,918,842,274,4635,1116,1.6288434675975,0.162389430856502
"31141",22521,1159,1416,6651,5081,2913,3664,1637,19946,5301,1.94545800637581,0.191394043189496
"31143",3613,77,238,1316,752,575,474,181,3298,655,1.49454436440257,0.122498832439997
"31145",7225,146,384,2278,1899,811,1229,478,6695,1707,1.82188411942714,0.196631635873703
"31147",5702,85,282,2261,1316,650,774,334,5335,1108,1.89850983258549,0.151772179078093
"31149",928,16,22,285,220,110,215,60,890,275,2.27769341774997,0.286625867687502
"31151",8891,1289,472,2472,1907,1131,1068,552,7130,1620,1.60696116417549,0.158614415150499
"31153",121171,2143,3293,25261,27679,12956,31655,18184,115735,49839,1.31862443953469,0.0687380730128394
"31155",14957,272,524,4546,3174,2093,3024,1324,14161,4348,1.98236135797704,0.211328920403502
"31157",24224,1180,1398,6881,6268,2434,4226,1837,21646,6063,1.98719304941077,0.209345818395381
"31159",11053,210,412,3154,2278,1623,2403,973,10431,3376,1.61096108969855,0.159335869516497
"31161",3551,104,256,1170,938,371,547,165,3191,712,3.54999411765222,0.700540677499106
"31163",2174,67,115,762,572,213,305,140,1992,445,1.61320918847763,0.158983467612999
"31165",765,10,30,194,252,84,148,47,725,195,3.29640545033954,0.586304899693745
"31167",3917,109,95,1216,923,770,593,211,3713,804,1.39255705430589,0.121154148035502
"31169",3521,76,152,1164,852,476,562,239,3293,801,1.60161882588406,0.157483548539622
"31171",445,14,20,106,126,70,84,25,411,109,1.84970939589847,0.200658666035497
"31173",3655,111,235,1266,875,476,492,200,3309,692,1.63740146714901,0.111784577770506
"31175",2849,75,99,859,709,358,566,183,2675,749,1.61349859721444,0.1595050913975
"31177",14107,215,403,3840,3167,1723,3332,1427,13489,4759,1.68914715604122,0.109914080485086
"31179",5452,45,163,1578,1061,785,1130,690,5244,1820,1.6116704535127,0.125179565148
"31181",2423,34,103,789,615,406,301,175,2286,476,1.60181603258476,0.15748122566933
"31183",596,8,22,155,181,76,104,50,566,154,1.62533462111533,0.161787208976996
"31185",9566,135,409,2776,2353,1478,1617,798,9022,2415,1.61186092175244,0.159312758535003
"32510",41721,1790,3348,11062,11641,4247,6442,3191,36583,9633,1.21767469288378,0.0424028109753072
"32001",17053,401,700,5574,5395,1760,2209,1014,15952,3223,5.91189304409742,1.364219281529
"32003",1531475,87989,120631,428431,371911,127321,261517,133675,1322855,395192,7.36927088834648,2.09223960624239
"32005",38318,754,1452,9422,10062,4441,7604,4583,36112,12187,2.44645548672783,0.198633986140492
"32007",34485,1401,2411,11957,9742,3346,3691,1937,30673,5628,9.56476065132016,4.77906895997992
"32009",874,36,137,228,254,52,106,61,701,167,4.27092037946081,0.950563740304241
"32011",1012,23,27,418,370,62,88,24,962,112,5.22285269762374,1.14167824293499
"32013",11278,625,954,3877,2598,1017,1641,566,9699,2207,7.57064008935341,2.69361245409153
"32015",3860,225,233,1473,988,625,152,164,3402,316,6.31707901603933,1.50659986304903
"32017",3353,89,353,1361,830,211,297,212,2911,509,7.38080219209219,2.81257337047825
"32019",41921,1791,3827,13109,11792,4723,4657,2022,36303,6679,4.76165034921666,0.545835997272696
"32021",3278,69,299,1257,1036,166,356,95,2910,451,5.05546018295836,1.02005657932175
"32023",38974,1665,3615,14121,11272,3354,3316,1631,33694,4947,11.1520469728978,4.83763493810544
"32027",5101,174,637,2214,1202,345,266,263,4290,529,5.80597949367692,1.66796366397648
"32029",3042,21,163,825,899,274,598,262,2858,860,1.51834110854318,0.0717015231834996
"32031",334033,15779,22479,79277,79722,28743,66061,41972,295775,108033,7.53988898326673,1.80410169285888
"32033",6940,191,471,2982,1662,704,702,228,6278,930,6.37903821848313,2.41071584797002
"33001",47422,717,2342,13873,9900,5791,8642,6157,44363,14799,1.80963124615375,0.135493916918999
"33003",39252,530,1396,10882,7366,4410,8342,6326,37326,14668,2.94501553391155,0.288190041918314
"33005",53960,1159,2244,17152,10022,5542,11190,6651,50557,17841,2.25022735148963,0.208153517749579
"33007",24323,875,1759,9530,4580,2719,3068,1792,21689,4860,4.40795185915012,0.53817268437809
"33009",64356,1336,3174,16565,10477,5412,13912,13480,59846,27392,3.81992744121516,0.507960311551836
"33011",299095,7929,13283,76529,53062,29733,74644,43915,277883,118559,2.59148129570289,0.254774049098926
"33013",109851,2591,4878,31996,19027,11997,22461,16901,102382,39362,2.5711343441545,0.274329017227502
"33015",229184,2953,7310,57660,40275,22845,61750,36391,218921,98141,2.43032099020406,0.207703814631502
"33017",86389,1854,3473,23050,16153,9995,20513,11351,81062,31864,1.93830906541652,0.1098912930549
"33019",32274,952,2054,12105,4675,2939,5792,3757,29268,9549,2.1361405624141,0.158831428586983
"34001",191243,9096,14237,61970,35547,14146,36899,19348,167910,56247,1.97701560416872,0.165378093230832
"34003",673093,26259,21546,143874,93967,42615,208884,135948,625288,344832,1.34166668631183,0.068265161665494
"34005",326073,6618,13065,87753,61666,26702,84061,46208,306390,130269,2.3518594274962,0.223640272452207
"34007",359675,15675,23229,104746,66428,28586,73808,47203,320771,121011,1.46290230777142,0.061938043595931
"34009",71925,1646,2636,22516,14459,5511,15812,9345,67643,25157,1.53746520097884,0.0768026277119025
"34011",104749,7926,12208,40994,18522,7241,11675,6183,84615,17858,2.02882742760541,0.135736632131376
"34013",574904,39853,36819,160988,91276,35254,122794,87920,498232,210714,1.07427965453059,0.0357650173244989
"34015",208873,4496,8720,65461,38525,19653,47561,24457,195657,72018,1.71435536990399,0.0916202148979662
"34017",511622,39764,27863,121831,64297,24196,139613,94058,443995,233671,0.784151830814464,0.0154406241535384
"34019",92766,1829,2170,18549,13516,6312,29430,20960,88767,50390,1.76368174221508,0.120465172926336
"34021",259446,11788,15301,65735,37487,16018,60695,52422,232357,113117,1.48409784924814,0.0627714268052308
"34023",591823,29095,30544,142301,86287,38203,156970,108423,532184,265393,1.53088488961353,0.0872517846833969
"34025",452764,10286,16343,99443,72410,34633,134442,85207,426135,219649,2.05747062470135,0.133412849660967
"34027",358055,10066,9434,68137,48812,21977,115368,84261,338555,199629,2.30346080067657,0.133194360957503
"34029",429453,11185,19593,143516,82945,33812,90720,47682,398675,138402,2.07855813115236,0.205796048708678
"34031",346254,29453,22408,117593,55876,17572,70068,33284,294393,103352,1.528444141484,0.0550140493507554
"34033",45403,1303,3021,17413,8434,4631,7146,3455,41079,10601,1.95765673620497,0.0947020621917479
"34035",240875,7021,6598,46231,30821,15004,73249,61951,227256,135200,1.64874695818437,0.0839741696154998
"34037",104633,1499,3351,31010,20111,8794,25793,14075,99783,39868,1.67664024594159,0.148710128919287
"34039",389369,28448,21136,108536,62171,22717,88490,57871,339785,146361,1.0120915312847,0.0289700245820782
"34041",78608,1839,3510,24963,14170,7012,18037,9077,73259,27114,1.72647795989381,0.100294771795202
"35001",468113,17515,27956,104898,105450,42140,92427,77727,422642,170154,2.7312227720036,0.298742542407502
"35003",2928,92,59,1224,832,227,307,187,2777,494,5.42049609955392,1.74985312910989
"35005",41660,4284,4094,11058,11371,3796,4505,2552,33282,7057,7.00793023365376,1.52448128700152
"35006",18384,712,2631,5933,4326,1906,1894,982,15041,2876,5.37307156428783,1.16076055573742
"35007",9205,298,655,2907,2445,894,1164,842,8252,2006,4.50767726639971,0.982992940122487
"35009",29950,2228,3542,7251,7731,2827,4253,2118,24180,6371,2.6955166574095,0.358473618712891
"35011",1004,83,109,273,368,64,64,43,812,107,3.45468224743618,0.59224194926899
"35013",133628,14385,11346,28774,27926,11056,23326,16815,107897,40141,4.53931212906777,0.94674153856903
"35015",39421,2423,4267,12343,9786,3940,4084,2578,32731,6662,4.18683339985045,1.04279083609004
"35017",20334,889,1712,5552,5136,1617,3343,2085,17733,5428,5.6903777235161,0.988314591019273
"35019",3460,269,295,1712,632,259,205,88,2896,293,4.11242695069529,0.77388440994452
"35021",403,13,41,116,68,64,47,54,349,101,4.03336188078174,0.549255658754013
"35023",2937,208,285,1118,566,232,348,180,2444,528,4.57015207443948,0.850919555078367
"35025",43395,4929,5384,14128,9201,3313,3297,3143,33082,6440,4.65009537964372,1.0956795535768
"35027",15369,514,1005,4662,4174,1260,2175,1579,13850,3754,5.41672976482542,1.21742111477748
"35028",13631,103,145,1327,1871,845,3412,5928,13383,9340,0.951737602539948,0.028225102221498
"35029",16238,2182,2560,5783,2893,866,1222,732,11496,1954,3.50681074753938,0.734505383388739
"35031",45464,3694,5798,16513,10442,3466,2999,2552,35972,5551,5.64890443128847,1.4050440928634
"35033",3397,126,150,1320,1018,201,187,395,3121,582,4.00321620968111,0.499537986569
"35035",44899,2585,3553,13082,12390,4253,6003,3033,38761,9036,5.92175111806349,1.64910760718516
"35037",6176,196,778,2498,1255,490,603,356,5202,959,4.38750316396061,0.737687598697527
"35039",27664,1442,2355,9735,7120,2109,2795,2108,23867,4903,6.45398398658509,1.53630911643812
"35041",11240,817,1088,3504,2729,657,1642,803,9335,2445,3.87528862288822,0.62039649168375
"35045",80074,3191,8139,24190,22605,10005,7106,4838,68744,11944,5.27018089322435,1.44296178568533
"35047",19775,1083,1939,4914,5248,1868,2462,2261,16753,4723,5.76228240584491,1.21940211673949
"35043",102000,2608,6185,25447,25197,10992,18919,12652,93207,31571,5.20560989693196,0.957882926652018
"35049",115166,5159,6258,25053,22559,8770,23366,24001,103749,47367,3.14962301901069,0.491877536078495
"35051",9146,324,634,3246,2223,909,1114,696,8188,1810,4.98892093692313,1.06042063794999
"35053",10826,908,839,4382,1964,764,826,1143,9079,1969,5.70360182744242,1.68018728678699
"35055",25985,643,1408,6951,6137,2388,4743,3715,23934,8458,3.76332622990883,0.574871091097831
"35057",10385,434,879,3938,2913,641,1014,566,9072,1580,4.10967120904641,0.852058502810998
"35059",2894,141,312,1258,559,155,281,188,2441,469,4.55310265384561,0.997997658477428
"35061",51488,2880,4956,16308,12802,4574,5405,4563,43652,9968,2.62412938541483,0.272088238009999
"36001",211245,5608,9569,44863,33144,24438,47635,45988,196068,93623,1.77965152070117,0.151509343609002
"36003",30019,1057,1645,10579,5694,4328,3560,3156,27317,6716,2.19806927139076,0.29226152654444
"36005",959432,121703,126512,267253,166244,76829,128311,72580,711217,200891,0.711120886526232,0.0133551317951146
"36007",131719,4148,8265,40251,23732,17245,20267,17811,119306,38078,2.47221513609581,0.201788323506985
"36009",53033,1944,3571,21080,9263,6555,5693,4927,47518,10620,2.84131468527909,0.37366169191118
"36011",55644,1864,4771,17969,10501,8201,7389,4949,49009,12338,2.46305051840242,0.209979134206062
"36013",89632,3149,6419,31002,15985,12162,11639,9276,80064,20915,2.37517711133662,0.30638575192739
"36015",59612,1575,4710,20455,11006,7610,7684,6572,53327,14256,1.54428282209294,0.11586248645995
"36017",34016,897,2913,14001,6174,3821,3425,2785,30206,6210,2.35860026955226,0.254880984276501
"36019",55169,1827,5044,19428,8928,5940,7995,6007,48298,14002,2.53131920727972,0.328837578083635
"36021",47055,1359,2772,13856,6782,5871,8527,7888,42924,16415,1.91735547642842,0.18324718279878
"36023",29478,880,2047,9035,5683,3559,4650,3624,26551,8274,1.51434080120714,0.142469215497
"36025",33007,801,2481,13047,5375,3717,4095,3491,29725,7586,3.021265216659,0.414309546500797
"36027",208945,6139,11562,54838,35965,21725,41871,36845,191244,78716,2.2242177021527,0.23143736755738
"36029",670059,18752,34204,175869,120553,80209,134769,105703,617103,240472,3.28184862248291,0.300243670831778
"36031",28937,650,1912,9713,4645,3200,5034,3783,26375,8817,3.58256778916512,0.558015869066489
"36033",34305,1396,2672,12979,5565,4275,4013,3405,30237,7418,3.26685916565088,0.498542077654197
"36035",38825,1226,3700,14303,6631,5880,4018,3067,33899,7085,1.93618907052037,0.152617218707494
"36037",41830,887,2209,16063,7630,5844,5465,3732,38734,9197,1.71230854401247,0.141629582901501
"36039",36124,1278,3081,13319,5069,4124,4914,4339,31765,9253,2.06687135870908,0.186009169196003
"36041",3985,85,724,1074,541,745,431,385,3176,816,3.44269413162088,0.522496556437995
"36043",43007,1181,2747,15415,8114,6330,5266,3954,39079,9220,3.86051770081082,0.419393728107504
"36045",74808,1958,4647,24284,16230,9495,10704,7490,68203,18194,4.97373949820864,0.391192529187773
"36047",1876692,158254,147728,473782,238397,116651,443269,298611,1570710,741880,0.711703321312579,0.0227691761012429
"36049",18551,456,1188,8038,2770,2608,2018,1473,16907,3491,2.68309301617688,0.374034471509499
"36051",42037,1070,2351,12917,7799,5750,6389,5761,38616,12150,2.5110110337783,0.182275181144496
"36053",46541,938,2433,16439,7711,6804,6423,5793,43170,12216,2.64057635344492,0.188825247447003
"36055",525462,15807,30997,121141,86119,61453,115255,94690,478658,209945,2.20497098287982,0.191056028525933
"36057",34244,1257,2628,12202,6859,4713,3722,2863,30359,6585,1.68888635268698,0.117142562433506
"36059",970356,42964,37547,211529,140316,77257,252192,208551,889845,460743,1.74093295281306,0.0870350122282584
"36061",1280680,79510,69257,156704,126110,48018,409438,391643,1131913,801081,0.624652392502876,0.00886653367194652
"36063",152677,3691,9092,48485,28900,22327,23310,16872,139894,40182,2.07980231496311,0.152610861394826
"36065",160555,7236,10722,49484,30267,20741,23985,18120,142597,42105,3.17046831109239,0.361021788983495
"36067",325273,8859,19386,82746,55176,40368,65469,53269,297028,118738,2.41895000021739,0.230358024377002
"36069",79559,1851,3507,20288,13289,10796,15987,13841,74201,29828,2.30979030477119,0.188977310596505
"36071",254625,9094,16582,72736,49367,26792,46564,33490,228949,80054,2.38890345034952,0.233837600192293
"36073",29710,1084,2782,12062,5480,3182,3362,1758,25844,5120,1.41993507662792,0.112772280912959
"36075",80360,2084,6172,29943,14770,10656,9565,7170,72104,16735,2.92032339664252,0.293217908878461
"36077",39686,790,2055,12789,6213,4605,7023,6211,36841,13234,2.88440004227888,0.288722135452
"36079",70537,1852,2850,18591,12092,5885,16480,12787,65835,29267,1.218835861963,0.068687127197969
"36081",1730502,173680,125667,461885,247072,135146,363463,223589,1431155,587052,1.21378734631308,0.0345525369733774
"36083",113700,2890,5883,31059,19692,15137,22446,16593,104927,39039,1.8488707869105,0.189339699661551
"36085",344389,17431,21827,102905,56700,25352,72956,47218,305131,120174,0.612475781020969,0.0163110898562952
"36087",209115,10341,12963,46259,35466,16332,48224,39530,185811,87754,1.07717364259549,0.0554398681009607
"36091",169377,3264,7388,40688,26401,19384,39890,32362,158725,72252,2.48043008453506,0.241667538088999
"36093",109234,3330,6140,29584,19629,14221,20136,16194,99764,36330,1.3121637876644,0.059705548432995
"36095",21494,542,1473,7817,4110,2557,2868,2127,19479,4995,1.96958438301181,0.177909340937003
"36097",13296,387,833,4650,2599,1590,1747,1490,12076,3237,1.65934482766858,0.0969367892034997
"36099",24507,1295,2443,8166,4084,3259,3067,2193,20769,5260,1.65998271442267,0.111249880841505
"36089",71971,3050,5153,25640,12332,8834,8628,8334,63768,16962,3.79773619858199,0.826583676664721
"36101",66770,1920,3739,23375,10993,9734,8469,8540,61111,17009,2.72069956135373,0.396839083199785
"36103",1064835,51964,50340,274855,176907,102869,221164,186736,962531,407900,5.10990211144588,0.319038532258787
"36105",55324,3005,4394,17906,9388,5679,8526,6426,47925,14952,2.71980417226793,0.27928024670961
"36107",34740,688,1849,12438,6044,4753,5461,3507,32203,8968,2.0582855501707,0.147562533007038
"36109",62148,1138,1997,10847,7900,5918,15060,19288,59013,34348,1.8636040489601,0.139314100160498
"36111",133449,3306,8146,37702,24403,13880,24741,21271,121997,46012,2.92672561435131,0.326089315787497
"36113",49287,1186,2997,13854,8909,6050,8399,7892,45104,16291,2.73320841473082,0.268800131898002
"36115",45104,1725,3383,17596,8126,4988,5403,3883,39996,9286,2.86004731168973,0.243083408156977
"36117",65000,2248,4033,21139,13074,8621,9671,6214,58719,15885,1.95334470508375,0.175530644311212
"36119",693253,39209,38077,127801,91236,45801,172540,178589,615967,351129,1.92516134723173,0.132613994702773
"36121",29604,947,2485,11187,5521,4103,3300,2061,26172,5361,1.89040343374608,0.169689696390503
"36123",16550,1664,622,5693,2800,1721,2341,1709,14264,4050,1.50975915291671,0.106809202950499
"37001",113559,5624,8329,32480,24882,12324,20999,8921,99606,29920,1.41587623732831,0.112474495216503
"37003",26182,1126,2795,10424,4890,3046,2801,1100,22261,3901,1.15660797369,0.0681821304795016
"37005",8383,508,1214,2610,1617,725,1067,642,6661,1709,1.35043350793025,0.0615487236420561
"37007",16003,737,2067,6566,3260,1492,1397,484,13199,1881,1.72983296487349,0.137287005320578
"37009",20327,757,1881,6342,4593,2779,2523,1452,17689,3975,1.57271548877169,0.111777501286516
"37011",13616,715,1176,4023,3186,1264,1998,1254,11725,3252,1.28488079051242,0.0641578446780613
"37013",32694,1650,2376,10453,7657,3898,4191,2469,28668,6660,3.76517818399722,0.221518217275902
"37015",13540,780,1906,4990,2889,949,1236,790,10854,2026,2.55127857372336,0.183835528488554
"37017",21504,980,2249,6966,5370,2132,2583,1224,18275,3807,2.57443386368786,0.2259843942725
"37019",106425,2181,5490,29757,22875,12415,21512,12195,98754,33707,2.58940390045835,0.22565434915489
"37021",197429,6135,9924,45409,34771,17716,50348,33126,181370,83474,2.40733264808347,0.170029774832002
"37023",64184,4209,6501,20051,13287,8164,7613,4359,53474,11972,1.938379718337,0.1327205990075
"37025",146766,4830,8850,37076,31613,13367,32964,18066,133086,51030,1.35591628998168,0.0935058996765005
"37027",58127,3866,6897,19073,12504,6142,6558,3087,47364,9645,1.65950702601986,0.122785072045502
"37029",7201,395,329,2239,1543,979,1115,601,6477,1716,1.93324217941244,0.0639243942875313
"37031",51691,1014,3080,12350,13568,6096,9364,6219,47597,15583,6.38184224391222,0.144241730191231
"37033",16670,985,1937,5863,3351,2013,1603,918,13748,2521,1.34519956330151,0.111457120544368
"37035",111117,5079,9927,32965,22811,13673,18275,8387,96111,26662,1.55117062803985,0.107247539192501
"37037",55274,2597,3221,10851,9075,4665,13447,11418,49456,24865,2.26588332496994,0.182865010723
"37039",22046,700,1540,7249,4708,2879,3182,1788,19806,4970,1.86738562125825,0.119553517558246
"37041",10479,523,1099,3300,2045,1145,1506,861,8857,2367,1.29449979247623,0.0458684755131445
"37043",8419,288,651,2111,1859,1239,1328,943,7480,2271,1.40241490626927,0.0564703959126989
"37045",68162,2823,6482,23769,13975,8226,8181,4706,58857,12887,1.55363846593013,0.12026298859424
"37047",36358,1906,3895,13275,8421,3749,3459,1653,30557,5112,2.85074819053368,0.242106725814038
"37049",67388,2654,4286,17560,17876,7786,10300,6926,60448,17226,3.25569868527222,0.187092825412352
"37051",206945,4802,11800,55060,59357,22352,34988,18586,190343,53574,2.14125633913093,0.1685162119575
"37053",19775,430,1100,6175,5049,1869,3612,1540,18245,5152,3.0169924036554,0.076119458505149
"37055",27537,461,835,6115,6440,2623,7338,3725,26241,11063,4.666454146902,0.106803937080503
"37057",118281,4863,11948,38289,27537,12866,16453,6325,101470,22778,1.93505304152955,0.146597189881003
"37059",30322,893,2079,9872,6759,2789,5260,2670,27350,7930,1.44713253774647,0.0689550183820005
"37061",33770,2781,4082,10695,7721,3237,3790,1464,26907,5254,1.9958181734835,0.209621756953001
"37063",221730,11239,11081,38304,32980,15656,58874,53596,199410,112470,1.28315644650712,0.077135199609501
"37065",34555,1784,3536,13184,7264,2767,4383,1637,29235,6020,1.73464439634334,0.131076960246504
"37067",255704,10599,16842,64200,53303,22585,54626,33549,228263,88175,1.52935505181185,0.106924739840998
"37069",47169,2777,3589,14166,10963,5036,7268,3370,40803,10638,1.69106162075026,0.128173769161999
"37071",156840,6368,14496,47150,35053,17298,25166,11309,135976,36475,1.56083292819465,0.0933172077668508
"37073",7719,283,539,3173,2068,809,507,340,6897,847,1.39154119497658,0.0899848498762743
"37075",5813,307,708,2091,1341,579,510,277,4798,787,1.42047601192173,0.0774285962731024
"37077",43172,2653,3366,13189,9404,4473,6865,3222,37153,10087,1.69736758509813,0.13967831894984
"37079",14564,1458,1801,4782,3157,1800,1114,452,11305,1566,1.22711780796428,0.0687371327294993
"37081",358620,13214,21972,82609,73867,33512,85234,48212,323434,133446,1.68776908702331,0.170420243136001
"37083",35073,2094,4968,12996,6995,2846,3420,1754,28011,5174,2.68956937581719,0.189666686981997
"37085",86972,3693,6355,25222,20903,10818,13448,6533,76924,19981,1.82287403877748,0.154428300851001
"37087",46420,1550,3217,12517,10640,5620,7797,5079,41653,12876,2.00787201975229,0.14276266022208
"37089",86286,2626,4595,21705,19525,9342,17962,10531,79065,28493,1.74549819251469,0.0962726103095014
"37091",15440,791,1715,5519,3368,1529,1362,1156,12934,2518,1.8386418939653,0.0932775634780599
"37093",33660,1481,2649,9580,8603,4672,4524,2151,29530,6675,1.46174162126647,0.100170233744499
"37095",3618,42,728,1264,795,386,308,95,2848,403,4.0167830284809,0.181764185715628
"37097",127236,3904,7442,34436,28092,13127,27876,12359,115890,40235,1.91565899689684,0.154280086601999
"37099",27730,1067,1934,8087,5353,3316,4524,3449,24729,7973,1.93696311423581,0.126977856076442
"37101",140984,6337,9563,38991,32697,18714,24875,9807,125084,34682,2.00486228090733,0.204754726504502
"37103",6919,381,768,2493,1596,661,759,261,5770,1020,2.19063437994484,0.121165960168001
"37105",42487,2533,3582,11309,10470,5741,5967,2885,36372,8852,1.26029794039726,0.0666674623664988
"37107",38461,2425,4878,13199,7810,4779,3693,1677,31158,5370,1.64629374969812,0.102936714934493
"37109",61702,2063,4792,18770,14048,7065,10230,4734,54847,14964,1.46730324709586,0.0784392852579965
"37113",27486,1223,1843,8834,6479,2518,4355,2234,24420,6589,2.015099579753,0.133095209018382
"37115",15388,542,1063,4794,2992,1118,3265,1614,13783,4879,1.96168644318665,0.116683419592768
"37117",16080,1025,1789,5561,3376,1996,1570,763,13266,2333,2.25008084916373,0.1180055799715
"37111",32576,1526,3230,10663,7142,4068,4148,1799,27820,5947,1.77657455557376,0.114837994065996
"37119",744125,34896,33348,123146,142833,60692,227443,121767,675881,349210,1.91159901115781,0.140113419378708
"37121",11127,455,846,3422,2760,1160,1535,949,9826,2484,1.66292855521148,0.0574626443058511
"37123",18061,1075,2125,6089,3721,2068,2077,906,14861,2983,1.83000687329678,0.128773692303501
"37125",70877,2185,3279,14206,14196,8563,17113,11335,65413,28448,2.23410942977846,0.181159737463496
"37127",65387,2814,5451,21484,13518,7842,10212,4066,57122,14278,1.84395991885789,0.140452444785502
"37129",155381,3228,6425,29894,32409,16880,43607,22938,145728,66545,1.48752627012321,0.0556372850559909
"37131",13605,915,1677,4630,2771,1342,1435,835,11013,2270,2.41526734326524,0.143305193103837
"37133",108760,2819,6132,32215,28696,11898,18455,8545,99809,27000,2.32901396008226,0.204398840887337
"37135",91994,2487,3300,11847,11431,6578,24476,31875,86207,56351,1.31283899920321,0.103882596560001
"37137",9735,294,719,3002,2474,954,1263,1029,8722,2292,2.08457275921952,0.0934744234664215
"37139",27563,1011,1957,8012,6649,2856,4702,2376,24595,7078,1.46880631336525,0.0603245741285314
"37141",42269,1326,3169,11156,9663,4706,8080,4169,37774,12249,2.47374334161258,0.224405454657365
"37143",9788,429,913,2835,2770,850,1120,871,8446,1991,1.63080290784753,0.0653627341654641
"37145",27883,930,2472,9554,6771,3254,3524,1378,24481,4902,1.30014647190945,0.105153390706125
"37147",104485,3585,6954,25535,21261,13047,21331,12772,93946,34103,2.21937298842259,0.168852718664003
"37149",15148,413,700,3874,3427,1618,3250,1866,14035,5116,1.15415334241844,0.0611895200328878
"37151",99762,5443,10622,34866,22657,10146,11492,4536,83697,16028,1.81738409892708,0.203768739306496
"37153",29414,1987,3110,9264,6705,3188,3291,1869,24317,5160,2.06208602193191,0.122742481756656
"37155",76804,5445,11521,25587,15512,7864,7045,3830,59838,10875,2.39509425907291,0.241812379297723
"37157",65739,3460,7207,22272,15537,7040,6909,3314,55072,10223,1.60197145333266,0.149010986006237
"37159",100710,4399,8821,33154,23196,11117,14074,5949,87490,20023,1.75340573174557,0.135048075965996
"37161",46621,2109,4643,15031,10545,5285,5960,3048,39869,9008,1.94447385100555,0.145761890998889
"37163",39867,3023,4227,13975,8387,4396,4051,1808,32617,5859,2.68873900365158,0.242376405436
"37165",23165,1074,3250,7788,5297,2202,2264,1290,18841,3554,1.36423893125774,0.0818295744472974
"37167",43631,1961,4125,14259,10084,5378,5579,2245,37545,7824,1.64212564139526,0.103906695730002
"37169",32806,1428,3062,13280,7207,3250,2849,1730,28316,4579,1.40480488139092,0.118676706159925
"37171",50583,3942,5662,14503,11069,5795,6480,3132,40979,9612,1.76998367236709,0.139601144813575
"37173",9660,534,910,3114,2068,967,1264,803,8216,2067,2.59674887486202,0.138948084952336
"37175",25228,550,1473,6105,5633,2410,5754,3303,23205,9057,1.61202676223443,0.0975428038220342
"37177",2639,105,522,1018,546,152,189,107,2012,296,1.67908631003338,0.105790578953199
"37179",151239,6236,8702,35054,30553,13712,38379,18603,136301,56982,1.77438399247336,0.163509605556834
"37181",28880,1370,3125,10281,6646,2519,3303,1636,24385,4939,1.14018326714862,0.0698747852163441
"37183",747572,21261,26126,108711,122295,60082,249226,159871,700185,409097,2.15215875781532,0.221303515153495
"37185",13942,625,1365,5460,3061,1306,1402,723,11952,2125,1.48342474715943,0.115620866597722
"37187",7969,650,661,2854,1975,834,804,191,6658,995,1.441390453708,0.096870858841548
"37189",31678,937,1258,6686,5973,2754,7712,6358,29483,14070,1.36843587387975,0.0813375740806916
"37191",78168,4921,6150,23258,18167,9704,11347,4621,67097,15968,1.73357151119784,0.143259172061502
"37193",47931,3059,5965,15451,10305,5124,5634,2393,38907,8027,2.18736332925466,0.196302536550504
"37195",53846,3740,5860,17705,10725,5183,6969,3664,44246,10633,1.34343414386976,0.0962472544304979
"37197",26517,1520,2293,9419,6347,3234,2872,832,22704,3704,1.40708766125344,0.0876015806909962
"37199",13739,501,1153,4852,3015,1425,1755,1038,12085,2793,1.60584659774751,0.0809689685940018
"38001",1579,38,77,591,386,185,190,112,1464,302,2.66704174747686,0.297921893510083
"38003",7576,162,230,2344,1602,1022,1691,525,7184,2216,2.79016090085452,0.463048772939006
"38005",3404,108,347,1000,687,600,477,185,2949,662,4.10959929858953,0.449895234514504
"38007",600,9,26,227,82,96,103,57,565,160,2.66599046540184,0.353383409094503
"38009",4437,76,223,1271,1087,690,852,238,4138,1090,3.78512047724984,0.538065399772894
"38011",2086,35,167,737,418,336,299,94,1884,393,2.77084034810389,0.351687679047671
"38013",1512,22,68,450,422,221,271,58,1422,329,2.74141133550359,0.357845371375924
"38015",65931,1429,1942,15232,12443,10348,17475,7062,62560,24537,3.24919228456481,0.510900041587993
"38017",116151,2157,3355,21855,24225,16058,33328,15173,110639,48501,4.032880393932,0.54083096870639
"38019",2643,71,75,718,692,429,570,88,2497,658,3.05791051890176,0.478515299578963
"38021",3268,137,117,920,655,614,623,202,3014,825,2.6837241762285,0.344110359923542
"38023",1568,58,56,392,404,291,286,81,1454,367,3.0581624963515,0.410481268720302
"38025",2917,165,150,1010,645,374,424,149,2602,573,3.6141919078008,0.642068003329498
"38027",1696,90,86,532,389,181,320,98,1520,418,2.12086435032107,0.200002421703501
"38029",2474,158,121,906,575,269,326,119,2195,445,3.04798207861392,0.470214088165965
"38031",2395,64,119,667,503,493,445,104,2212,549,2.05408669657729,0.199818781442503
"38033",1345,22,58,368,341,240,232,84,1265,316,2.44986652159506,0.306823484883656
"38035",43477,735,1281,9335,10279,6149,10197,5501,41461,15698,3.32258873346678,0.448618188764739
"38037",1742,76,40,595,401,264,297,69,1626,366,4.5087845011127,0.504411963616492
"38039",1659,89,37,490,374,173,365,131,1533,496,1.94416329935655,0.2213770918535
"38041",1851,97,113,623,488,219,241,70,1641,311,2.7031015723125,0.343664478971498
"38043",1641,73,107,567,382,199,269,44,1461,313,2.72703831371001,0.438741639417506
"38045",2936,210,133,867,761,280,523,162,2593,685,2.70103720413711,0.349081938053493
"38047",1339,102,34,405,263,231,247,57,1203,304,2.45820028551437,0.306604677920502
"38049",3830,100,200,1266,878,587,617,182,3530,799,3.29384012948822,0.599377754995996
"38051",1998,216,91,692,359,317,232,91,1691,323,2.43397232840134,0.299688632626111
"38053",8346,119,442,2679,2001,1104,1524,477,7785,2001,5.02644487432227,0.888454708527774
"38055",7034,237,301,2258,1571,1164,1179,324,6496,1503,5.13977830062733,0.721205107859508
"38057",5926,255,321,1566,1392,1140,906,346,5350,1252,3.14757046739095,0.342755695241491
"38059",22667,666,1155,6166,5327,3172,4977,1204,20846,6181,4.70358825851537,0.592703396014014
"38061",6123,203,440,1991,1331,850,910,398,5480,1308,3.70945000462901,0.608332384728992
"38063",2224,53,96,663,537,328,412,135,2075,547,2.33777846146818,0.314431371975001
"38065",1273,32,48,364,400,167,195,67,1193,262,2.29352759511953,0.224449020896991
"38067",4969,210,259,1549,1172,704,830,245,4500,1075,3.02606059235133,0.355242147765316
"38069",2850,98,100,855,610,363,539,285,2652,824,3.03353887617658,0.339471861551985
"38071",7879,120,583,2142,1566,1461,1418,589,7176,2007,3.48866120382532,0.408216413258501
"38073",3960,77,219,1499,825,499,694,147,3664,841,2.20299422620764,0.261979272003994
"38075",1526,62,36,484,398,190,285,71,1428,356,3.00392060910417,0.282642699126169
"38077",10605,303,492,2698,2492,2223,1939,458,9810,2397,3.37632907994752,0.436949789484824
"38079",7167,241,723,1864,1906,1193,884,356,6203,1240,2.2885895224043,0.297664325128342
"38081",2772,42,128,952,644,451,420,135,2602,555,2.24776558267328,0.26145081172838
"38083",1047,63,69,420,234,115,138,8,915,146,2.32047692622605,0.311303042564501
"38085",2107,67,256,732,483,282,190,97,1784,287,5.20831521595914,0.340038118655822
"38087",580,12,40,173,83,120,124,28,528,152,2.93713867829544,0.369854562269539
"38089",21076,615,1034,6753,4715,2493,4021,1445,19427,5466,3.02988113591095,0.409139757448507
"38091",1328,10,40,321,400,164,353,40,1278,393,1.93492111854693,0.221001030977495
"38093",14959,516,754,5380,3340,1399,2683,887,13689,3570,3.48028733157143,0.703657623328006
"38095",1626,71,123,504,408,276,185,59,1432,244,2.36859175624944,0.329453788546147
"38097",5453,152,159,1369,1287,829,1205,452,5142,1657,2.80927000532864,0.266418021403856
"38099",7421,519,436,2523,1567,1036,913,427,6466,1340,3.81154514577447,0.406774551935518
"38101",43919,1238,1484,13187,9897,5218,9134,3761,41197,12895,4.44442934105861,0.644496056422996
"38103",2951,105,147,1128,649,276,560,86,2699,646,2.64785166890581,0.399645445799501
"38105",24054,440,1668,7120,5772,3183,4505,1366,21946,5871,4.19332054378391,0.674886716456987
"39001",18790,1110,1958,7934,2950,1840,1591,1407,15722,2998,1.73311204343878,0.157558029834672
"39003",68724,1513,4571,27706,14193,7602,8175,4964,62640,13139,1.58733498958543,0.112432523361499
"39005",35169,1248,2380,14761,6175,2798,4952,2855,31541,7807,1.6295543775951,0.118054085081007
"39007",68764,2924,6432,29835,13681,5520,7199,3173,59408,10372,1.82885447808151,0.198636622906505
"39009",35877,704,2555,11222,6119,3058,5466,6753,32618,12219,1.85216322891736,0.137535841846906
"39011",31358,458,1524,13260,6187,3641,3735,2553,29376,6288,1.80683807407712,0.11068340999651
"39013",49324,948,3233,22782,8683,5786,5013,2879,45143,7892,1.68112818794801,0.147925538652204
"39015",30525,838,3215,13926,5527,2569,2788,1662,26472,4450,1.83793115143436,0.132627169454828
"39017",248873,6426,14675,81168,47516,19923,51006,28159,227772,79165,1.54736812608212,0.127341857147519
"39019",19375,834,1157,9276,3254,2122,1660,1072,17384,2732,1.51476973240001,0.109902045552496
"39021",27030,531,1850,12076,5607,2439,3103,1424,24649,4527,1.50906261597284,0.117618531627501
"39023",93032,2269,8205,34950,20725,9339,10613,6931,82558,17544,1.49142931454978,0.109871187941496
"39025",144038,3784,9835,45879,28516,13583,26879,15562,130419,42441,1.51581761131263,0.123957363338828
"39027",28323,668,1822,10788,6381,2981,3619,2064,25833,5683,1.38662507455225,0.111702431466497
"39029",73718,2141,5591,33268,13620,7552,7648,3898,65986,11546,1.79775263161937,0.14770619636812
"39031",25332,1790,2191,10785,3981,2263,2822,1500,21351,4322,1.73136907977292,0.155681557935005
"39033",29581,929,2019,13680,5286,3037,2996,1634,26633,4630,1.357625871524,0.111381540463492
"39035",891369,24450,58296,243671,186931,71614,177904,128503,808623,306407,1.95970589508926,0.127996796328682
"39037",35330,576,2509,16249,7316,2786,3870,2024,32245,5894,1.63368162271688,0.164221865806476
"39039",26115,684,1376,10508,5542,2998,3140,1867,24055,5007,1.67370373697751,0.115353469096694
"39041",139455,1147,2746,22603,23862,9518,47866,31713,135562,79579,1.59268291383461,0.125425693597997
"39043",54564,1009,3410,19362,11609,5424,9001,4749,50145,13750,1.79295218655248,0.0716552728554406
"39045",106494,1596,5273,34603,23461,9399,20921,11241,99625,32162,1.73503132008012,0.138407199496998
"39047",19817,619,2503,8995,3215,1567,1784,1134,16695,2918,1.40222357053485,0.110462220208003
"39049",878641,26891,48140,210885,168227,62511,224277,137710,803610,361987,1.69782017391341,0.148431848274504
"39051",29229,515,1500,12382,6109,3577,3414,1732,27214,5146,1.49264630050405,0.113953582417278
"39053",20146,890,2114,8163,3578,1926,2076,1399,17142,3475,1.83517033762205,0.126564958334429
"39055",65803,3890,2303,16793,12723,4810,16183,9101,59610,25284,1.5414859149355,0.114054018232004
"39057",112683,2088,4647,25627,23017,10957,23982,22365,105948,46347,1.44546825172991,0.113181813599002
"39059",26978,1095,2718,11590,4954,2639,2621,1361,23165,3982,1.74485212012604,0.144419133302504
"39061",558526,13144,31864,144656,101631,45851,134288,87092,513518,221380,1.74484078289325,0.111432512626757
"39063",51621,596,2789,18514,10571,4687,9091,5373,48236,14464,1.61533973515802,0.147919399346997
"39065",18785,659,1134,9325,3206,1372,1883,1206,16992,3089,1.53033985218173,0.129756846454497
"39067",10570,414,814,5257,1509,1282,823,471,9342,1294,1.46124593704612,0.112666834545997
"39069",19110,403,825,8552,3529,2427,2263,1111,17882,3374,1.55956095869615,0.116924721071498
"39071",29502,1517,3284,12527,4854,3166,2492,1662,24701,4154,1.7124840497978,0.150666151129504
"39073",19939,677,1694,8434,3858,2331,1978,967,17568,2945,1.75244291834118,0.114897185017507
"39075",26086,9295,2037,8353,2680,976,1765,980,14754,2745,1.59352753542802,0.116795902153998
"39077",39839,1144,2858,18481,7554,3836,4084,1882,35837,5966,1.58127718153663,0.137671030191496
"39079",22260,1091,1703,10335,3520,2244,2134,1233,19466,3367,1.43068984944748,0.113554485404501
"39081",46594,884,2510,20386,8405,5904,5555,2950,43200,8505,1.51916180691325,0.112857372296599
"39083",40948,1513,1869,16274,8502,3501,5932,3357,37566,9289,1.76396477215223,0.145505518136503
"39085",167916,3229,8464,52584,38275,16919,31244,17201,156223,48445,1.37830517485688,0.0645444947903352
"39087",41207,1180,3374,18369,7687,3622,4328,2647,36653,6975,1.7909792950876,0.122502574555152
"39089",120311,1984,6642,40183,25591,11492,23287,11132,111685,34419,1.84985324685952,0.188001259319497
"39091",31915,405,1889,14236,6241,3426,3778,1940,29621,5718,1.53066529205119,0.128244947588498
"39093",216629,4098,15612,67562,50223,22826,35993,20315,196919,56308,1.7557682279887,0.137589892792128
"39095",293517,7307,21566,87399,65783,30604,50444,30414,264644,80858,2.13042679746653,0.0971373937857789
"39097",31650,854,2832,12839,6487,2312,4241,2085,27964,6326,1.68607192691044,0.127269924904996
"39099",163772,4118,9912,61455,34085,13504,26265,14433,149742,40698,1.65879825323112,0.117869667247375
"39101",46269,1391,3265,20500,11085,3945,3947,2136,41613,6083,1.64154009087505,0.111353995915002
"39103",127513,1678,4613,38679,25454,12435,29208,15446,121222,44654,1.53883107008094,0.117478685070997
"39105",15837,673,1682,7248,2469,1800,1316,649,13482,1965,1.93928956984981,0.116743620967366
"39107",27775,252,1717,12167,4509,3464,3763,1903,25806,5666,1.48913982980626,0.130336051477296
"39109",75022,1054,4060,28342,15974,7357,11285,6950,69908,18235,1.42164998844525,0.111980564583498
"39111",9820,258,740,4908,1601,1074,780,459,8822,1239,1.58948405304419,0.124475498184804
"39113",367475,8804,24162,102217,87204,37786,64727,42575,334509,107302,1.5161245993571,0.126365091343501
"39115",10045,320,1218,4532,1763,1120,724,368,8507,1092,1.68448792539786,0.114570495374495
"39117",24404,980,1714,11114,4975,1969,2596,1056,21710,3652,1.5465772440521,0.112067125188004
"39119",59106,1683,4332,25262,10910,6137,6386,4396,53091,10782,1.8775891132338,0.183676984617503
"39121",10774,396,1218,5592,1469,791,857,451,9160,1308,1.83869492518332,0.110127545506501
"39123",30468,491,1838,10823,6501,2886,5164,2765,28139,7929,2.29571047045636,0.0738926762908554
"39125",13007,270,1065,5847,2440,1280,1531,574,11672,2105,1.44876068179121,0.116303965528077
"39127",24453,474,2255,11707,4361,2379,2124,1153,21724,3277,1.62716638687728,0.112234579199498
"39129",40813,963,4265,16723,7757,3125,5293,2687,35585,7980,1.73982788221167,0.137674014902
"39131",18808,806,1992,8744,2920,1580,1817,949,16010,2766,1.59493369122881,0.119651721436495
"39133",106088,1882,6185,39039,18505,8587,19109,12781,98021,31890,1.50001428161654,0.140068877554996
"39135",28859,571,1924,12839,5689,2540,3268,2028,26364,5296,1.36245164223353,0.116055290841411
"39137",22899,361,881,9078,3646,3265,3820,1848,21657,5668,1.64878042466767,0.134262719434505
"39139",86935,3123,6920,35288,18087,8016,10005,5496,76892,15501,1.7019266677249,0.138166221014001
"39141",54706,1502,4632,24130,10746,4471,5702,3523,48572,9225,1.92400671017,0.187554109622001
"39143",41439,698,2371,17511,8568,4773,4983,2535,38370,7518,1.69138889266385,0.114759282515681
"39145",51774,1867,5389,22305,9905,3821,4912,3575,44518,8487,2.27001213937938,0.165503155500913
"39147",37318,584,2021,16611,7642,3778,4408,2274,34713,6682,1.6948294697541,0.153509089909499
"39149",32123,683,2651,13197,5682,3787,4069,2054,28789,6123,1.45157925093593,0.112715084023494
"39151",261959,5302,14877,100003,57163,22833,40107,21674,241780,61781,1.85333858020269,0.160476557413499
"39153",381538,8593,19552,112545,79812,31532,82270,47234,353393,129504,1.54631941283438,0.116680375845508
"39155",144883,4738,10890,63958,26512,10877,18226,9682,129255,27908,1.70140671464774,0.177329096062381
"39157",64304,3074,4405,29489,10686,4840,7811,3999,56825,11810,1.77412221340305,0.157103632355497
"39159",41789,482,1873,12840,7839,2960,10318,5477,39434,15795,1.5297712865778,0.119858550686501
"39161",19845,249,1163,8874,3787,2467,1991,1314,18433,3305,1.53412387660083,0.113534916370249
"39163",9061,452,1338,3914,1350,822,837,348,7271,1185,1.70093686466228,0.112191095618493
"39165",162214,2716,6041,41882,26513,13454,43256,28352,153457,71608,1.41576255259263,0.1103976735505
"39167",42918,763,2928,16619,8863,5236,5203,3306,39227,8509,2.48243615938084,0.17344010668886
"39169",76742,6373,4307,29573,13022,5513,10943,7011,66062,17954,1.60374314384501,0.153916226879997
"39171",25826,420,1727,11082,5944,2891,2402,1360,23679,3762,1.47290974193141,0.118310192961071
"39173",82182,1291,2851,24066,16147,8027,17824,11976,78040,29800,1.730313684274,0.172958357534504
"39175",15308,330,645,7159,2642,1561,1867,1104,14333,2971,1.417895527039,0.112714838818505
"40001",12870,599,1849,6027,2378,654,899,464,10422,1363,1.63396426115333,0.149247104406222
"40003",4276,161,457,1501,933,326,659,239,3658,898,1.95157542626041,0.230352680765462
"40005",9873,438,1172,4114,2036,666,963,484,8263,1447,2.51802322267352,0.251264145622008
"40007",3392,282,231,1098,773,280,551,177,2879,728,2.90233215633885,0.475134574718053
"40009",15252,575,1682,5938,3651,1169,1523,714,12995,2237,2.25604570395589,0.231890459217343
"40011",6327,458,618,2226,1569,388,738,330,5251,1068,2.08518364349643,0.242683223134507
"40013",30556,1172,2766,9903,7515,1956,4720,2524,26618,7244,3.0953939006532,0.238361912808992
"40015",18352,854,1777,7940,4025,1043,2018,695,15721,2713,2.45649068792156,0.330617081722491
"40017",100354,3086,4885,27052,24105,9737,22456,9033,92383,31489,2.15916390154176,0.233066857511056
"40019",32123,1159,2957,11684,7554,2304,3856,2609,28007,6465,2.14349466024537,0.211358263291
"40021",29879,1170,2356,9696,6897,1701,5294,2765,26353,8059,2.04367469247482,0.200668689081003
"40023",9736,485,1106,3780,2351,629,903,482,8145,1385,2.49587921826863,0.202160914975816
"40025",1578,119,99,586,268,49,407,50,1360,457,2.94017859538566,0.481067346440138
"40027",187614,4276,10712,47144,44557,15866,39162,25897,172626,65059,1.91580551597017,0.143018764028499
"40029",3592,192,351,1533,705,182,369,260,3049,629,1.54111854717297,0.132717839017504
"40031",77597,2078,5212,24859,20898,5985,11126,7439,70307,18565,2.37221027344426,0.276068675046498
"40033",3852,86,545,1590,835,151,466,179,3221,645,1.93731431412474,0.162817240466835
"40035",9897,379,921,4051,2181,920,943,502,8597,1445,1.90320100088354,0.199323070362634
"40037",49137,1072,3939,19711,11767,4227,5910,2511,44126,8421,2.23216574147537,0.250692098420002
"40039",16842,777,1207,4573,4194,1114,3355,1622,14858,4977,2.20171794473054,0.258259328894003
"40041",29533,1179,3200,11014,6513,2264,3690,1673,25154,5363,1.86129027381434,0.206102428641882
"40043",2893,49,165,1236,695,168,386,194,2679,580,2.20305658484407,0.260994305370998
"40045",2686,114,214,1004,687,173,351,143,2358,494,2.82348260138853,0.319732250592374
"40047",40926,1889,2943,15134,7727,3656,6551,3026,36094,9577,2.14476354801567,0.275743934505496
"40049",17366,715,1340,7671,3962,776,1935,967,15311,2902,2.34244078605493,0.207367859956506
"40051",37248,908,2728,14687,7939,2718,6189,2079,33612,8268,2.34731963898476,0.282625923975455
"40053",2793,91,162,998,609,270,474,189,2540,663,2.10823942177707,0.262407358339463
"40055",4031,128,560,1485,1058,373,371,56,3343,427,2.23264398122552,0.1644728672065
"40057",1763,187,135,583,480,97,215,66,1441,281,1.69530340032142,0.137370928093884
"40059",2296,118,129,719,668,147,369,146,2049,515,2.16175042127377,0.272021356474137
"40061",8042,343,888,3212,1580,749,899,371,6811,1270,2.17509535375927,0.160383870965503
"40063",9084,378,1135,3670,1935,579,836,551,7571,1387,2.08831335393791,0.208484749967995
"40065",16057,1068,1120,4377,3846,1716,2621,1309,13869,3930,3.23004029575676,0.204657176588146
"40067",3692,202,408,1555,805,160,451,111,3082,562,2.37606726702449,0.195899516733646
"40069",7040,226,677,2528,1341,651,1101,516,6137,1617,1.87045774597107,0.167011172468995
"40071",29211,733,2694,9835,7279,3522,3639,1509,25784,5148,2.26109963700838,0.247202073429796
"40073",9719,540,509,4018,2058,406,1506,682,8670,2188,1.95038005077165,0.234403037595
"40075",5933,221,607,1961,1526,516,838,264,5105,1102,3.13904211202763,0.263342861046504
"40077",6519,244,640,2445,1321,1028,587,254,5635,841,1.92883623695861,0.186211666061998
"40079",32447,1736,3385,13027,6218,3113,3420,1548,27326,4968,3.08313333107418,0.41081683785192
"40081",23109,552,1993,9674,5522,1900,2385,1083,20564,3468,1.99601536277633,0.249118221668502
"40083",32566,784,1938,10128,7250,2593,6813,3060,29844,9873,1.9754782610009,0.193666480753005
"40085",6728,350,707,2601,1703,361,780,226,5671,1006,2.36534383601246,0.134396131111662
"40093",5239,267,281,2162,1153,401,712,263,4691,975,2.46795937805731,0.248984691758494
"40095",10540,831,1143,3903,2193,800,1200,470,8566,1670,1.76095614717842,0.10794388392012
"40097",26881,945,2266,10885,6219,2591,2930,1045,23670,3975,1.7374580719738,0.177630363062005
"40087",27608,675,2275,8677,6769,2016,4857,2339,24658,7196,2.49131006733279,0.148412208091499
"40089",20539,1112,2161,8860,4078,1327,2092,909,17266,3001,3.97629750449395,0.481404373229878
"40091",13974,561,1353,6111,3166,1007,1233,543,12060,1776,2.14989713892715,0.182932362465999
"40099",9519,429,937,3955,2026,482,1221,469,8153,1690,1.84604846438356,0.108050889098496
"40101",44339,1635,4445,15431,9411,4548,6292,2577,38259,8869,2.64739629204239,0.216439815905504
"40103",7437,210,567,2658,1747,666,1076,513,6660,1589,2.19477775959527,0.193167879296498
"40105",6586,166,551,2705,1416,694,756,298,5869,1054,1.60836558818093,0.151895667481346
"40107",7924,459,985,3151,1848,636,558,287,6480,845,2.28151461167394,0.161702636190999
"40109",516864,26011,33853,127327,115467,40004,109478,64724,457000,174202,1.76149852698765,0.184963370212003
"40111",24591,841,2458,8575,6106,2896,2541,1174,21292,3715,1.91872536800278,0.181052445481998
"40113",32618,740,2743,11954,7753,3231,4268,1929,29135,6197,4.23091106468436,0.601173829999441
"40115",19892,788,1938,7003,5015,2075,1946,1127,17166,3073,1.50114020724848,0.126799092945787
"40117",10789,287,922,4553,2317,838,1348,524,9580,1872,2.43354505565271,0.154640788070506
"40119",44471,1091,2430,12141,8640,3156,9659,7354,40950,17013,2.10493330687281,0.18067722994849
"40121",30693,1014,2970,11470,6693,2819,3817,1910,26709,5727,2.90885416210123,0.352019961644008
"40123",24706,644,1972,7932,5232,1681,4420,2825,22090,7245,2.21463129668236,0.184870515982001
"40125",48103,1073,4384,16689,12037,4111,6313,3496,42646,9809,2.33410695832802,0.203433807282997
"40127",7761,375,749,3433,1513,519,697,475,6637,1172,2.73095877885321,0.361302593824997
"40129",2377,50,157,829,686,180,313,162,2170,475,2.61178799081363,0.295696415946624
"40131",64397,1568,3674,21200,15280,6550,11308,4817,59155,16125,2.0946563712482,0.18508763027649
"40133",15758,701,1817,5564,4136,1295,1557,688,13240,2245,2.24069063026665,0.164131143899003
"40135",26917,1465,3234,10609,5092,2681,2780,1056,22218,3836,2.08998933273589,0.183725073926835
"40137",29706,935,2668,12610,6593,1519,3508,1873,26103,5381,1.9427959947675,0.226565582403996
"40139",13079,2263,1243,3048,2746,382,2228,1169,9573,3397,3.1635910131377,0.535454551956456
"40141",4769,481,521,1606,1050,271,583,257,3767,840,2.48909570551953,0.22317885825724
"40143",437508,17159,27355,110919,100057,38825,94364,48829,392994,143193,2.25755814501391,0.152147384832499
"40145",54945,1406,3541,17017,13815,5257,9625,4284,49998,13909,2.09440780362506,0.152870755155
"40147",35625,778,2603,11805,7456,2540,6918,3525,32244,10443,1.58069425182582,0.110848995375229
"40149",7451,158,620,3072,1762,411,862,566,6673,1428,2.33218247072208,0.258871574422998
"40151",5422,153,308,1664,1283,263,1196,555,4961,1751,2.82708409215566,0.337211281570003
"40153",13932,504,1182,5640,3261,615,1875,855,12246,2730,2.52155912209576,0.324494570697497
"41001",12261,195,935,3599,3280,1284,2143,825,11131,2968,6.08735737971348,0.908336867006906
"41003",57817,856,1287,8353,11500,4968,16514,14339,55674,30853,2.6342889676786,0.198786741366998
"41005",297372,5837,11005,64399,72397,28128,74752,40854,280530,115606,4.07738501257266,0.558360125485499
"41007",30011,444,1917,8241,8421,3259,5019,2710,27650,7729,2.58639184180217,0.256558343528834
"41009",37780,554,3052,12418,10862,4108,4651,2135,34174,6786,1.94606336133704,0.207096531312064
"41011",48337,895,3959,14537,14690,4611,6068,3577,43483,9645,3.36200423065306,0.466506233182286
"41013",18070,235,1420,5715,5104,1918,2626,1052,16415,3678,4.62852029324413,0.870184078167485
"41015",18953,629,904,5208,5673,1974,2616,1949,17420,4565,4.4169460185312,0.463777146704605
"41017",142950,2802,5303,28930,36057,14599,34341,20918,134845,55259,6.02553330681464,0.886452895390993
"41019",81606,2049,5667,26143,24162,8278,10138,5169,73890,15307,7.32365565230684,1.45607271290363
"41021",1478,25,72,478,460,115,259,69,1381,328,4.11272281355981,0.363729339528933
"41023",5559,125,401,1977,1694,393,666,303,5033,969,6.09353792397911,1.32686123741651
"41025",5397,139,364,1987,1604,472,472,359,4894,831,7.60778505460671,2.92738701408961
"41027",16398,1774,973,3131,2979,1242,3453,2846,13651,6299,1.80903391137741,0.159084904503473
"41029",159237,4189,10350,40224,42517,14151,29224,18582,144698,47806,3.90100543643085,0.793729375803025
"41031",16709,804,1227,4914,4792,1486,2366,1120,14678,3486,4.0373177930578,0.526107608314502
"41033",65167,1057,4933,19899,21121,6374,7896,3887,59177,11783,3.41901094787167,0.464469105728935
"41035",48298,1780,3838,15812,11999,4665,6614,3590,42680,10204,6.41915321787341,1.74588821948929
"41037",6074,330,517,2056,1534,483,741,413,5227,1154,7.32388466238686,2.38197038802459
"41039",263395,5295,13441,59763,73363,26010,50716,34807,244659,85523,7.06450274526765,1.34116641928064
"41041",38478,861,1932,9263,11927,3492,6764,4239,35685,11003,2.63218448809533,0.291772976365286
"41043",88473,2512,6174,25556,27247,9455,11554,5975,79787,17529,4.77377760356647,0.676564734912495
"41045",20286,1465,2290,6423,5220,2024,1866,998,16531,2864,7.66741632044725,2.84834450210893
"41047",228187,16147,16547,58589,59313,21668,36856,19067,195493,55923,4.80514728615373,0.351547622263498
"41049",7585,764,946,2521,2021,541,529,263,5875,792,3.56073310122956,0.609467590726788
"41051",596686,20726,24819,101565,123094,44646,170794,111042,551141,281836,2.88955818825104,0.138889547030927
"41053",56120,1526,3203,12871,15482,5769,10500,6769,51391,17269,2.20938591130797,0.219539447604498
"41055",1285,53,110,397,346,148,135,96,1122,231,3.41380892626595,0.24740497894687
"41057",20381,493,1409,5995,5956,1969,2882,1677,18479,4559,3.43115575967924,0.335233117366878
"41059",52380,3982,4798,15548,12969,5570,6112,3401,43600,9513,5.30691162839987,0.965051119999082
"41061",17495,316,953,5787,4652,1555,2944,1288,16226,4232,5.0544677656424,0.605952790013492
"41063",5577,61,273,1574,1654,477,966,572,5243,1538,4.63862957141553,0.941023622593346
"41065",18659,945,1476,5035,5224,2067,2365,1547,16238,3912,5.4401052559073,0.709858655686922
"41067",413222,15057,13893,71481,88918,35614,116062,72197,384272,188259,2.80778000318179,0.216913064753
"41069",1135,15,103,362,304,128,140,83,1017,223,3.35787052141621,0.505136495060518
"41071",72578,2972,4202,17332,20709,6731,13069,7563,65404,20632,2.71789927652431,0.213157633819001
"42001",73207,2544,4951,29157,12724,6264,10028,7539,65712,17567,1.5764933407479,0.142188463638284
"42003",903181,14152,30232,234448,142501,90858,226244,164746,858797,390990,2.2469471529299,0.204699058903
"42005",48743,1045,2663,23866,7087,5043,6181,2858,45035,9039,2.50083506809544,0.183536579410495
"42007",123306,1725,4997,45305,23894,15445,21870,10070,116584,31940,1.41576095836824,0.122501073399767
"42009",34884,1076,2599,17339,5065,3302,3389,2114,31209,5503,2.34255604798196,0.277808073031142
"42011",290856,14133,22085,106288,46704,26345,47676,27625,254638,75301,2.20912355863605,0.237961000681002
"42013",88407,1923,4814,39331,13724,8095,13904,6616,81670,20520,2.0388050140172,0.144839881090501
"42015",42563,1117,3046,20203,6198,3690,5151,3158,38400,8309,2.38727635340649,0.325716995357585
"42017",461927,8487,16983,128121,73448,36638,117667,80583,436457,198250,2.12871779479287,0.170703008207742
"42019",137763,1484,4710,43065,20824,15044,33763,18873,131569,52636,1.83647620514643,0.220282021350499
"42021",96023,2003,5221,42381,14463,10491,14477,6987,88799,21464,2.06442814521402,0.190600371270999
"42023",3551,62,207,1846,790,269,304,73,3282,377,1.49793977410642,0.111148800994503
"42025",47866,1498,3143,21490,7952,5323,5407,3053,43225,8460,1.66477601074047,0.107265718235001
"42027",98016,2060,3465,27689,12125,7725,22574,22378,92491,44952,3.6691073238903,0.308135245656498
"42029",363335,9199,10748,72108,47646,22912,117806,82916,343388,200722,2.62480136507389,0.207381883180291
"42031",25619,806,1646,12183,2971,2363,3475,2175,23167,5650,2.11761860389417,0.169540139785503
"42033",60117,2347,4500,28481,7943,5803,7257,3786,53270,11043,2.82517781133326,0.320036986834506
"42035",24821,758,1709,11797,3451,2304,3215,1587,22354,4802,2.72060533659857,0.249558350843009
"42037",43709,983,2907,19234,5916,3834,6735,4100,39819,10835,1.70844918548092,0.136088149913001
"42039",59128,2218,3539,27920,8810,4687,7550,4404,53371,11954,2.55707133789752,0.290587247228718
"42041",180435,4359,7810,57062,28303,13974,42713,26214,168266,68927,2.35601746920819,0.150676788974997
"42043",197113,6596,11315,64805,32186,18628,40767,22816,179202,63583,2.01728882157786,0.153401029059001
"42045",391102,8456,17210,109181,66624,31048,90883,67700,365436,158583,1.26951603132914,0.05207318337881
"42047",22738,369,1228,11270,2794,2800,2963,1314,21141,4277,2.59157631919834,0.232024207061005
"42049",187367,5035,10593,69820,29090,18848,34297,19684,171739,53981,2.50547670972104,0.227689008218953
"42051",95091,2545,7885,45513,13746,8384,11317,5701,84661,17018,2.61911608856297,0.21793324709534
"42053",6100,264,748,3257,902,244,523,162,5088,685,1.91363128780519,0.120167962918495
"42055",109036,3611,8067,46862,16221,9228,15324,9723,97358,25047,2.19975065904905,0.210919380210943
"42057",10592,348,857,5196,1471,1052,998,670,9387,1668,1.573044306973,0.119535688714956
"42059",25855,827,2262,11590,4155,2365,3065,1591,22766,4656,1.99146170138937,0.157513237105865
"42061",32137,957,2279,16083,4586,2622,3769,1841,28901,5610,2.81951659840268,0.244361988404
"42063",55006,1625,2924,22760,8434,5124,8000,6139,50457,14139,2.2797801458496,0.230105259082505
"42065",31686,1008,2012,16212,4041,3224,3421,1768,28666,5189,1.90699985951192,0.182382242547494
"42067",16513,912,1892,8115,2006,1192,1638,758,13709,2396,2.07871682461449,0.108319254677003
"42069",152192,4097,8750,55017,24872,14675,27396,17385,139345,44781,1.62974698144612,0.129779562922504
"42071",371834,24661,26075,127880,54031,28637,70451,40099,321098,110550,2.55018132581147,0.268890584736477
"42073",62019,1402,3708,27035,10512,6040,9373,3949,56909,13322,1.32601298525453,0.100281422124205
"42075",97689,4144,8006,41794,14656,7544,13708,7837,85539,21545,1.35559091051707,0.0995533305609989
"42077",253632,10268,15876,81618,42094,23979,49049,30748,227488,79797,1.49656118769881,0.0959465186334981
"42079",231684,7630,15028,88518,40325,24531,34355,21297,209026,55652,2.28493619792045,0.251842619753
"42081",80475,1856,5696,30958,12775,9618,13031,6541,72923,19572,2.89700617625023,0.346586281583001
"42083",28892,632,1492,13613,4535,2978,3627,2015,26768,5642,2.30550053025623,0.276249393572687
"42085",78991,2378,5420,32995,12243,7680,12012,6263,71193,18275,1.81115771848961,0.190061722173982
"42087",32369,1342,3408,16075,4599,2639,2867,1439,27619,4306,1.86318592731057,0.114308803193493
"42089",117650,3684,8492,40417,23829,10566,18610,12052,105474,30662,2.1157053001682,0.171193138528199
"42091",599028,11529,20477,136362,82885,43783,171657,132335,567022,303992,2.05036822541681,0.133490932526003
"42093",13234,333,772,4744,1687,992,2366,2340,12129,4706,1.05828565422942,0.0366711619484998
"42095",218671,5815,12473,73343,35242,20112,44165,27521,200383,71686,1.79264142690231,0.104175172565025
"42097",67082,1883,5079,33069,9521,5589,8385,3556,60120,11941,2.31770263766693,0.131965180541501
"42099",32862,1125,2535,15289,4804,3223,3929,1957,29202,5886,2.50275212598393,0.152634249738499
"42101",1094956,55600,91668,343452,182332,65808,201321,154775,947688,356096,1.23031636232128,0.0389958070687153
"42103",43658,575,2443,14903,9482,4562,7013,4680,40640,11693,2.28579290984266,0.157926677497743
"42105",11965,372,889,5552,2064,1138,1294,656,10704,1950,2.16085575172869,0.303283467231619
"42107",104588,3050,8033,47377,16015,11520,12720,5873,93505,18593,2.22083435243206,0.216043736715003
"42109",26625,1467,2129,11630,3322,2316,3543,2218,23029,5761,1.50751900694111,0.0915960999300017
"42111",55614,2037,3818,27226,7920,5222,6102,3289,49759,9391,2.57322523543303,0.295356062336216
"42113",4892,106,365,2384,626,534,593,284,4421,877,1.52588120465167,0.126268599467494
"42115",28879,507,2231,13365,4557,2604,3600,2015,26141,5615,2.03002562082378,0.233542619095518
"42117",29434,603,2047,12950,5004,2745,3714,2371,26784,6085,2.30236203730677,0.318869269335863
"42119",29373,1014,2446,12399,3536,2304,3968,3706,25913,7674,1.57629859985912,0.0880118745154987
"42121",37602,1024,2134,17667,5775,3699,4860,2443,34444,7303,1.97993946600408,0.190427377812511
"42123",28558,528,1437,13193,4722,3112,3576,1990,26593,5566,2.13661064574697,0.252253668042528
"42125",150457,2623,6608,54941,23117,15441,30666,17061,141226,47727,2.61006885667092,0.23577291327186
"42127",39333,960,2766,17422,6937,3542,4596,3110,35607,7706,2.6036872259523,0.210121112748784
"42129",263310,3907,9534,94051,43843,30973,51807,29195,249869,81002,3.52022636749139,0.284244255530504
"42131",19008,240,1103,8805,3232,1653,2599,1376,17665,3975,1.51910467245028,0.113182756662997
"42133",317148,8730,20537,123317,52276,30440,52343,29505,287881,81848,2.6952631133985,0.248462685157725
"44001",35697,883,2117,7413,5270,2358,9045,8611,32697,17656,0.525737064642831,0.00792751038873416
"44003",125594,3026,6439,35915,25469,13452,25703,15590,116129,41293,1.31566971535008,0.0492159513263075
"44005",63375,1330,2217,12700,10356,4661,18535,13576,59828,32111,2.26019231789819,0.0307291570362109
"44007",451912,29533,32988,138042,78703,34438,83859,54349,389391,138208,1.62113765894865,0.121523697717401
"44009",90037,1304,3671,19646,15931,7984,23381,18120,85062,41501,1.93724308953221,0.0982215979608314
"45001",17124,720,2070,6331,2639,2243,2184,937,14334,3121,1.67376532600077,0.129682970121647
"45003",118532,4441,8251,37476,23730,10495,21694,12445,105840,34139,2.66703880901106,0.271616101421293
"45005",5881,346,1054,2328,1148,396,339,270,4481,609,1.99010728749792,0.103056736476122
"45007",139287,5202,14539,42521,26548,16064,21622,12791,119546,34413,2.15455821080335,0.192166654765907
"45009",8993,546,1471,2578,1780,1047,964,607,6976,1571,1.67672113485942,0.0990581279354957
"45011",13924,1066,1518,5084,2660,1652,1318,626,11340,1944,1.73008556258923,0.139634497817016
"45013",135181,2965,5960,29787,27234,11983,33328,23924,126256,57252,2.96902552844691,0.175701969143907
"45015",150410,5034,10658,44274,34022,15332,26894,14196,134718,41090,3.19182028845524,0.309015840613496
"45017",10410,641,811,3723,2040,1310,1284,601,8958,1885,2.31421018258353,0.0988096947019987
"45019",290167,6271,14374,60891,48551,24460,84101,51519,269522,135620,4.72409309001437,0.255560772252332
"45021",38100,1949,4400,14271,7874,4048,3161,2397,31751,5558,1.66835221327467,0.101661222072923
"45023",22528,1027,2444,9342,4682,2112,1969,952,19057,2921,1.80064774279507,0.149349896688999
"45025",30531,1981,4111,11994,6153,2455,2449,1388,24439,3837,2.36300613554749,0.205208920269433
"45027",22801,1183,3429,8237,4670,1725,2144,1413,18189,3557,2.28999521807019,0.175147396211499
"45029",26943,972,2809,11449,4201,3136,2746,1630,23162,4376,3.67701666433185,0.268426251963236
"45031",43866,1997,4667,16041,8828,4177,5089,3067,37202,8156,2.23029730688006,0.143661214477002
"45033",18926,1223,2801,8041,3212,1348,1550,751,14902,2301,1.62923805531699,0.103211550951312
"45035",108360,3081,7279,28283,25553,12231,20942,10991,98000,31933,2.66203661882109,0.142859386263004
"45037",18911,880,2512,6507,3571,1772,2114,1555,15519,3669,1.68740695766248,0.12780846562263
"45039",15441,591,1798,6544,2804,1281,1623,800,13052,2423,1.92024925603035,0.180251328305504
"45041",92904,3424,9307,30457,16990,10168,14168,8390,80173,22558,2.62988985028076,0.203341788997501
"45043",47207,1506,3354,13016,10055,4791,8988,5497,42347,14485,2.47261072581624,0.218893153728902
"45045",354269,12412,24249,82361,67917,33083,85112,49135,317608,134247,2.96932726658995,0.203212962308548
"45047",46943,1986,4596,14891,7675,6454,7159,4182,40361,11341,1.74797668026103,0.117455908131498
"45049",13392,864,1617,5903,2355,1174,1021,458,10911,1479,2.12771911195597,0.140220894552015
"45051",258793,7000,16048,85006,60375,26953,40952,22459,235745,63411,2.80052997698877,0.28935980806364
"45053",20352,554,1730,7423,4125,1741,3363,1416,18068,4779,2.94160842667873,0.166639846765955
"45055",45386,1504,3139,16185,10052,4889,5941,3676,40743,9617,2.48434014410183,0.187829184298996
"45057",67958,2585,5642,19059,12590,7693,13146,7243,59731,20389,2.50646621709316,0.141437963968619
"45059",46384,2716,5580,16546,8886,4665,5328,2663,38088,7991,2.2043499538667,0.183751350643
"45061",11918,753,1362,4680,2314,916,1199,694,9803,1893,1.77970208460982,0.104117418403498
"45063",202130,6155,13265,54996,43798,20182,41024,22710,182710,63734,2.25107274297254,0.1912704251285
"45067",20459,1230,2781,9736,2808,1380,1572,952,16448,2524,2.66104905870108,0.125017495644501
"45069",19252,1252,2647,9239,3220,1354,966,574,15353,1540,1.90725168077104,0.123519195457632
"45065",7950,370,942,2799,1180,1010,1063,586,6638,1649,2.06411995028782,0.0993680779523604
"45071",26042,1202,2399,8883,5168,2929,3583,1878,22441,5461,2.19080314559434,0.16414131854
"45073",56952,2527,5380,16206,10834,6137,9583,6285,49045,15868,2.64192651159303,0.171754625900116
"45075",57651,2352,6690,18258,11011,8363,5979,4998,48609,10977,3.52259288060739,0.283273971214507
"45077",82323,3327,7705,24328,15641,8976,12311,10035,71291,22346,2.3263720621234,0.130938801634674
"45079",262135,5972,15485,56760,56880,23100,61175,42763,240678,103938,3.05035236791911,0.195151077754496
"45081",13402,1317,1192,4687,2191,1429,1619,967,10893,2586,1.57924892017899,0.116663656104998
"45083",218573,9310,18014,67289,46333,23212,33918,20497,191249,54415,2.04218740145585,0.209445341388264
"45085",69549,2568,5728,22075,16010,7604,9408,6156,61253,15564,2.80692754906375,0.172258936598005
"45087",19433,1022,2320,7411,4049,1992,1877,762,16091,2639,1.79666824716942,0.131351414693999
"45089",22382,1035,2561,9556,3745,1987,2232,1266,18786,3498,2.46590895126669,0.235787402343496
"45091",187116,4933,10767,44559,40066,19671,43786,23334,171416,67120,2.05861707205887,0.177948570466114
"46003",1716,89,82,646,275,310,231,83,1545,314,1.84177192380813,0.206182423143996
"46005",12441,1097,673,4198,2171,1331,1986,985,10671,2971,2.57743464327585,0.370139342704505
"46007",1753,49,157,537,472,184,311,43,1547,354,2.5465066501011,0.341424354084476
"46009",5108,216,365,1707,1056,600,786,378,4527,1164,1.97614517627131,0.166248163612123
"46011",18426,230,462,4524,3541,1751,5005,2913,17734,7918,2.04713677641225,0.2353877516873
"46013",25283,630,1087,7762,4670,2942,5890,2302,23566,8192,2.87993292564833,0.516975032294295
"46015",3476,241,175,1213,576,417,660,194,3060,854,2.19799949526416,0.244855676282002
"46017",999,21,167,411,230,101,60,9,811,69,1.76312974964129,0.141848785569503
"46019",6997,192,416,2833,1540,594,1025,397,6389,1422,3.63126107520523,0.668835844215238
"46021",1063,48,87,329,237,73,248,41,928,289,2.35705003451269,0.231015361255277
"46023",5718,274,399,2003,955,809,986,292,5045,1278,3.49827332298314,0.329996091036544
"46025",2473,71,81,1110,511,226,398,76,2321,474,2.19808587448547,0.285264189667003
"46027",7330,112,263,1887,1153,550,1722,1643,6955,3365,1.43002705041518,0.119173135012824
"46029",19236,646,974,7450,3521,2749,2718,1178,17616,3896,1.91526896562283,0.211895937821494
"46031",2155,36,266,776,446,297,260,74,1853,334,4.40401857164861,0.757037076131021
"46033",6647,201,268,2399,1358,645,1167,609,6178,1776,3.51267231648959,0.450677587494511
"46035",13421,517,841,4528,3057,1421,2354,703,12063,3057,1.41827254147985,0.126304523784003
"46037",3907,132,182,1487,756,522,626,202,3593,828,2.37133113454868,0.324576359514003
"46039",2968,87,163,1072,621,335,574,116,2718,690,1.7325076337121,0.18733530922074
"46041",2898,66,415,1059,556,307,342,153,2417,495,4.09600048062396,0.72473085045
"46043",1903,87,102,611,448,279,290,86,1714,376,1.64806591513668,0.1247484646245
"46045",2771,131,74,924,616,343,538,145,2566,683,2.66715227041615,0.342712104857999
"46047",5354,117,235,1936,1194,688,758,426,5002,1184,3.05999606719201,0.502073767075615
"46049",1473,24,100,443,311,222,205,168,1349,373,2.40679070656428,0.297671014317
"46051",5233,156,264,1974,1057,492,847,443,4813,1290,2.22214237286544,0.203848095820546
"46053",2776,71,196,1069,613,298,342,187,2509,529,2.84230890760533,0.302115161204639
"46055",1293,5,50,601,321,109,195,12,1238,207,3.59257343516892,0.533530933511497
"46057",3623,133,151,1425,735,412,581,186,3339,767,1.73441157134441,0.158170695524502
"46059",2156,102,52,636,478,349,411,128,2002,539,2.62645207700384,0.422413908061007
"46061",2133,65,38,774,413,454,287,102,2030,389,1.41748580688092,0.125825470928503
"46063",841,20,24,292,242,69,163,31,797,194,3.66589753783736,0.79972303427768
"46065",12306,111,346,3618,2462,1518,3049,1202,11849,4251,2.7745464112724,0.234303753439502
"46067",4965,246,229,1520,976,736,937,321,4490,1258,2.08382946766565,0.234088113623003
"46069",1009,29,58,331,225,197,117,52,922,169,2.13845037773273,0.254113004000994
"46071",1731,64,174,668,367,212,186,60,1493,246,3.56510368411176,0.541108610169001
"46073",1353,43,65,603,218,161,192,71,1245,263,1.71000187470268,0.154966874950498
"46075",668,0,38,228,82,62,181,77,630,258,3.01747758093845,0.281972828020007
"46077",3534,93,188,1366,641,397,589,260,3253,849,2.14540820024784,0.252582958736008
"46079",7793,243,437,2139,1677,723,1838,736,7113,2574,1.65552880225725,0.167229835610999
"46081",17977,227,784,5067,4068,1624,4213,1994,16966,6207,2.2916614340047,0.233947175777163
"46083",41258,465,1243,9592,7653,5286,11547,5472,39550,17019,1.98870512694171,0.1660101247485
"46085",2296,47,157,778,530,192,456,136,2092,592,4.51384669490447,0.495165198853992
"46091",3037,176,88,937,537,447,705,147,2773,852,2.24893558055507,0.265251080552313
"46087",3706,188,136,1327,664,437,656,298,3382,954,1.65460680295023,0.166736932069997
"46089",1665,126,105,657,241,176,292,68,1434,360,2.68119421234067,0.345061225283837
"46093",19727,211,678,5978,4819,2541,4123,1377,18838,5500,5.08663562515767,1.0217652048115
"46095",1190,63,162,435,256,100,131,43,965,174,3.75746881478961,0.378368889813004
"46097",1634,89,89,703,311,160,232,50,1456,282,1.65301931973342,0.166258975863997
"46099",128060,3704,5062,33038,26845,16557,29650,13204,119294,42854,2.04957339859614,0.235234655534437
"46101",4226,128,124,1351,972,523,780,348,3974,1128,1.56669299965091,0.151427411560904
"46102",7182,272,1650,2152,1918,446,421,323,5260,744,3.27196510354067,0.602606894866388
"46103",74604,1212,2930,21038,16552,8067,15926,8879,70462,24805,6.21236513894246,0.809362556490758
"46105",2104,55,117,705,469,319,307,132,1932,439,3.72535176858413,0.861583896637599
"46107",1840,77,33,718,360,203,350,99,1730,449,2.39785299052271,0.2658653713185
"46109",6522,232,430,2358,1472,979,765,286,5860,1051,3.07801635092857,0.339360553305805
"46111",1563,29,100,683,272,210,187,82,1434,269,1.65399537898647,0.1658771615365
"46115",4484,282,157,1422,954,483,958,228,4045,1186,2.69954069724774,0.445807790031492
"46117",2111,53,80,764,397,204,394,219,1978,613,3.79075876339586,0.443958407297499
"46119",1002,7,27,367,215,178,177,31,968,208,2.79108752115579,0.314807502672996
"46121",4621,232,752,1450,1357,215,311,304,3637,615,2.84200666612223,0.398900815497838
"46123",3893,109,359,1638,680,360,594,153,3425,747,3.31413086080496,0.464998728205272
"46125",5938,166,336,1953,1048,896,1191,348,5436,1539,1.78514547360852,0.177468282257998
"46127",11230,138,488,3167,2252,1323,2389,1473,10604,3862,2.51274736192134,0.133211745712598
"46129",3773,150,229,1359,655,433,685,262,3394,947,2.16859033836056,0.221751311018003
"46135",16166,449,924,5436,3235,1838,2648,1636,14793,4284,1.6993371340962,0.152200723459471
"46137",1496,9,153,629,328,159,188,30,1334,218,3.81761716758005,0.582319124031515
"47001",54743,1994,3556,18370,12676,4780,7273,6094,49193,13367,1.83161433069666,0.0893949320749974
"47003",32985,1765,3585,13777,6390,1541,4043,1884,27635,5927,1.83358280781477,0.122171173459503
"47005",11435,542,1201,5533,2032,747,857,523,9692,1380,1.91046304639455,0.113060676502501
"47007",11704,957,1787,5070,1846,745,824,475,8960,1299,1.75120626291757,0.104809579466504
"47009",96415,3405,6455,34623,19829,7634,15328,9141,86555,24469,2.21111858571364,0.146123134899354
"47011",73801,3313,5976,23355,17311,6937,10187,6722,64512,16909,1.37935881851187,0.0849241117131486
"47013",28413,2085,3578,11328,5912,1764,2226,1520,22750,3746,2.02813920299762,0.129618363267193
"47015",10240,590,995,4569,1866,684,1016,520,8655,1536,1.28501171347916,0.0686283960109997
"47017",19552,995,1340,7987,3998,1262,2422,1548,17217,3970,1.80541213381444,0.155276908401497
"47019",42028,1812,3739,15890,9224,3158,5187,3018,36477,8205,1.63590544288312,0.0903162108215688
"47021",28847,1272,2397,11066,5917,1854,4163,2178,25178,6341,1.74152189896301,0.0797818298
"47023",11317,375,1361,4753,2476,431,1098,823,9581,1921,1.5584369520694,0.0734927944409969
"47025",22947,2091,2033,8881,3993,1748,2503,1698,18823,4201,1.92488233457415,0.115019554160211
"47027",5572,484,512,2701,836,310,508,221,4576,729,1.57297091191432,0.0676081315673712
"47029",26035,1534,2683,12245,4543,1817,2000,1213,21818,3213,1.86486863529958,0.114599077858104
"47031",38910,1719,3032,14776,7374,3123,5266,3620,34159,8886,1.97441527950191,0.111797235648002
"47033",9473,572,928,3849,1931,722,1014,457,7973,1471,1.50974883871487,0.0686328887914992
"47035",46385,1905,3393,18196,10750,4130,4783,3228,41087,8011,2.03072014585647,0.177183957555497
"47037",492479,19241,29452,104797,90222,30005,136834,81928,443786,218762,2.05045152451649,0.136324373168161
"47039",8299,465,829,3567,1433,692,1003,310,7005,1313,1.65391939101262,0.0888717469885012
"47041",14200,1048,1715,5595,2315,763,1893,871,11437,2764,1.73556578121647,0.0851442880399987
"47043",37545,1466,3346,14900,7924,2948,4453,2508,32733,6961,1.73669752988843,0.127448013481498
"47045",24951,1054,1976,9308,5547,2018,3283,1765,21921,5048,1.89875005163242,0.136312146879022
"47047",31005,860,2447,10423,7411,2548,4864,2452,27698,7316,1.71104294837847,0.181028382775514
"47049",13201,1485,1122,5245,2267,976,1454,652,10594,2106,1.86797761315821,0.129783733684503
"47051",29084,1243,2057,12016,5295,2168,3680,2625,25784,6305,1.88166252494837,0.14742619073263
"47053",34266,1801,2619,13711,7769,2127,4024,2215,29846,6239,1.89709046350162,0.156273945006
"47055",21250,812,1826,9335,4013,1379,2541,1344,18612,3885,1.91064848875986,0.156649259026188
"47057",16952,1413,1989,6889,3170,1116,1457,918,13550,2375,2.16320716164304,0.0785783133539997
"47059",50635,2735,4821,21116,10147,3229,5407,3180,43079,8587,2.00385086219709,0.161938122266362
"47061",9511,832,1246,3966,1392,672,707,696,7433,1403,1.45813485209886,0.0927828597065004
"47063",44109,2753,3955,17036,8684,3721,5331,2629,37401,7960,1.48084856558079,0.0456286099120018
"47065",256225,8766,15636,64205,57071,23162,55776,31609,231823,87385,1.98474860771955,0.147537257432121
"47067",4806,471,428,2069,1142,163,200,333,3907,533,1.62930642364574,0.0581960499806133
"47069",18491,945,2357,8043,3937,1110,1341,758,15189,2099,1.64876695799416,0.171889915840006
"47071",19208,1083,1919,8557,3297,1242,2181,929,16206,3110,1.73549837143825,0.152821734255944
"47073",41361,2286,3262,17634,8359,3119,4587,2114,35813,6701,2.16863602673833,0.130079604511043
"47075",12485,594,1559,5837,2324,693,929,549,10332,1478,1.68965958187677,0.137540169616003
"47077",19271,900,1657,9034,3555,1512,1801,812,16714,2613,1.64220394806502,0.135528031072001
"47079",23444,1353,1986,10515,4300,1039,2685,1566,20105,4251,1.93563030192835,0.154224312308857
"47081",17810,994,2223,8221,3297,1274,1253,548,14593,1801,1.84200449520979,0.158195780751498
"47083",5830,289,626,2569,1074,503,483,286,4915,769,1.22001450192959,0.0537574809935041
"47085",13342,558,1265,6359,2199,855,1325,781,11519,2106,1.79760361201993,0.144200771600999
"47087",8724,699,926,3922,1427,597,906,247,7099,1153,1.40801362826396,0.0831051856590039
"47089",38818,1845,3443,14093,8663,3307,4714,2753,33530,7467,1.75475125929638,0.0814077195579992
"47091",13651,887,1701,5478,2593,1134,1243,615,11063,1858,1.54661503028219,0.0788317834537504
"47093",319008,8233,16857,79944,62283,28042,74830,48819,293918,123649,2.28272084589979,0.136135780546999
"47095",5443,484,948,2332,846,205,407,221,4011,628,1.48559705835775,0.050374867004127
"47097",17399,995,2555,8098,3070,1075,948,658,13849,1606,2.81796677525245,0.129822999246384
"47099",29583,1916,2197,12944,5557,2263,2772,1934,25470,4706,1.8943771362981,0.158442562557405
"47101",8641,619,818,3711,1910,726,520,337,7204,857,1.52500942779151,0.0726980064020004
"47103",24541,985,2524,10509,3868,1939,2874,1842,21032,4716,1.86110272732451,0.14620531640254
"47105",40184,1951,3141,12733,7914,3100,7233,4112,35092,11345,1.9069287627975,0.0638269392810031
"47111",16610,1417,1937,8125,2633,1012,979,507,13256,1486,1.24840008052942,0.0800245786109783
"47113",65820,2106,4820,21873,14977,4265,10754,7025,58894,17779,1.61800620908036,0.1439235943055
"47115",20505,1442,2355,8011,4212,1615,1893,977,16708,2870,1.61800482917782,0.131252285421017
"47117",23275,859,1976,9239,4902,2189,2843,1267,20440,4110,1.81973509481165,0.096749305907995
"47119",68730,2155,3958,22614,14769,7762,12125,5347,62617,17472,2.13437577895055,0.158625148633006
"47107",37439,1945,3303,14294,7838,3351,4428,2280,32191,6708,1.71473093442164,0.1110975615775
"47109",18351,758,1961,8817,3278,1339,1261,937,15632,2198,1.67768961400299,0.144414760192664
"47121",9250,640,913,4092,2034,572,651,348,7697,999,1.79915061800687,0.0557578019040008
"47123",32985,2314,2735,13116,7161,2599,3379,1681,27936,5060,2.55262452788437,0.167809879892489
"47125",134344,2776,5858,36120,34153,15314,25649,14474,125710,40123,1.77168131912263,0.141648671915051
"47127",4716,241,384,1893,727,384,753,334,4091,1087,1.60925394262605,0.0334775514204986
"47129",15389,907,1989,7040,2717,1015,1009,712,12493,1721,1.86885770823408,0.135483764283499
"47131",21643,1205,2472,9767,3753,1120,2170,1156,17966,3326,1.90495172019664,0.14443017082801
"47133",15797,1501,1444,7358,2688,767,1232,807,12852,2039,1.57136635847987,0.113051488325499
"47135",5775,668,621,2570,943,450,306,217,4486,523,1.73900733421515,0.1089875231105
"47137",3797,295,494,1434,689,283,424,178,3008,602,1.52615452125633,0.0455158034005007
"47139",12879,1008,1270,4616,2703,1458,1153,671,10601,1824,1.48473208420311,0.113307118642536
"47141",51141,2355,3334,18122,10740,2974,8276,5340,45452,13616,2.46098903639668,0.104398200186001
"47143",22284,1036,2725,8622,4390,1569,2670,1272,18523,3942,1.75166691925326,0.0866901408770026
"47145",39407,1187,2491,14264,9498,3595,4733,3639,35729,8372,1.88000284849511,0.102057318153497
"47147",49625,2331,3698,19514,9989,4099,7229,2765,43596,9994,1.76190603740414,0.124199435253727
"47149",212334,5683,10588,58332,48856,17678,49435,21762,196063,71197,2.48193776849962,0.161247039742999
"47151",14874,1121,1868,6868,2669,901,896,551,11885,1447,1.96020988529407,0.138759080572413
"47153",11476,590,1467,4568,2251,772,1159,669,9419,1828,1.46191751044468,0.068355557176503
"47155",70283,3003,6437,24848,16903,5868,8686,4538,60843,13224,2.08887573847478,0.154357994695227
"47157",610884,21527,43988,168383,134821,38709,120800,82656,545369,203456,2.38978135397633,0.20000844577178
"47159",13828,578,1193,5916,2782,960,1655,744,12057,2399,1.58333858405712,0.0844877124879982
"47161",9647,381,895,3944,1777,697,1317,636,8371,1953,1.52026059960645,0.128548556215912
"47163",115505,4343,9142,38514,22773,11063,19396,10274,102020,29670,2.19451473183126,0.111940167947165
"47165",132873,4408,7973,38700,30389,11755,26823,12825,120492,39648,1.95834951386689,0.141423341246718
"47167",40903,1453,3121,14840,9816,4034,4888,2751,36329,7639,2.60263089203842,0.120485501799528
"47169",7960,340,791,3637,1825,610,488,269,6829,757,0.99510688281054,0.0303566916520008
"47171",13458,694,1162,4952,3372,1121,1358,799,11602,2157,1.21662213997978,0.0483003126606016
"47173",13843,1246,1640,5861,2303,1154,886,753,10957,1639,1.36212977910134,0.0642094394589993
"47175",4485,441,415,2212,628,340,265,184,3629,449,1.3666672047628,0.0708067272084978
"47177",27979,1719,2978,12903,4594,1792,2673,1320,23282,3993,1.61088835895677,0.111896087131999
"47179",91126,2736,5786,26311,19461,6695,17362,12775,82604,30137,1.52819275017098,0.0857235822464973
"47181",12400,795,1377,5587,2449,784,977,431,10228,1408,2.00153856819608,0.188672335733048
"47183",21386,960,1780,9364,3708,1025,2771,1778,18646,4549,1.84645473042218,0.15114310738303
"47185",19206,1389,2167,7772,3941,1361,1599,977,15650,2576,1.84864877369685,0.0981327921910028
"47187",158362,2633,4055,20402,22744,10432,60968,37128,151674,98096,2.09363432888047,0.1509926218385
"47189",99352,2363,4602,28718,20609,7358,24299,11403,92387,35702,2.26854945964255,0.151290343217
"48001",42541,2371,5261,16454,10206,3154,3500,1595,34909,5095,3.60573429719531,0.265934687811001
"48003",10992,1554,1077,3441,2017,834,1531,538,8361,2069,2.57874758117465,0.372281196790581
"48005",56662,3916,5261,17909,14472,4881,6817,3406,47485,10223,3.22639882367153,0.212087004980497
"48007",18333,1036,1034,6044,4233,1445,3028,1513,16263,4541,3.68446579043877,0.0692706947648028
"48009",6026,161,402,2295,1418,397,914,439,5463,1353,1.93929913403186,0.232943893722498
"48011",1305,53,50,356,366,132,233,115,1202,348,1.94467687375625,0.233576602166003
"48013",31019,2828,3169,12335,6491,1598,3495,1103,25022,4598,2.26945052153823,0.292660331159998
"48015",20600,1216,1418,6949,4840,1256,3438,1483,17966,4921,2.47330910360622,0.1587697472195
"48017",4330,384,833,1481,776,208,441,207,3113,648,1.8366336174714,0.209292105024299
"48019",15922,577,901,4574,3809,1683,2726,1652,14444,4378,2.11988412237803,0.192663114809495
"48021",62214,4854,4877,19484,14263,4342,9872,4522,52483,14394,1.83074065170523,0.217084348176501
"48023",2481,53,345,934,499,162,382,106,2083,488,1.91247394024812,0.226777345170502
"48025",21326,1776,2694,6908,5894,1525,1445,1084,16856,2529,2.19624189872186,0.209988726543503
"48027",222239,8047,11727,57657,61159,24641,38679,20329,202465,59008,2.18267476776671,0.266779473750504
"48029",1278847,86375,100696,311876,290496,105853,238332,145219,1091776,383551,2.70375437512464,0.302541976160996
"48031",8682,481,374,2493,2137,962,1693,542,7827,2235,1.68319625550244,0.173227933227994
"48033",358,10,18,89,78,27,118,18,330,136,1.90820934526921,0.225767823647006
"48035",13102,527,846,4347,3727,1247,1676,732,11729,2408,2.5504218988451,0.247530510912002
"48037",62976,2032,4421,21271,15715,5096,9258,5183,56523,14441,3.90006240841879,0.231826172437627
"48039",240577,11276,15646,58256,58700,21431,48515,26753,213655,75268,3.09433474366724,0.350352151952507
"48041",124953,6611,7487,26178,23612,8314,28902,23849,110855,52751,2.73788074169243,0.144109570128501
"48043",7160,271,589,1173,1545,285,1891,1406,6300,3297,5.98108693243016,1.49671318033143
"48045",966,57,86,345,230,97,94,57,823,151,1.92284921786646,0.229317809072004
"48047",4739,636,855,1257,1062,74,619,236,3248,855,2.05586575772239,0.222248705093012
"48049",26497,1112,2348,9231,6672,1992,3788,1354,23037,5142,2.08051482983742,0.235974725426999
"48051",12432,690,1448,4229,2664,782,1908,711,10294,2619,2.40056132301279,0.164716452075004
"48053",34781,1987,1979,10565,8535,2038,6210,3467,30815,9677,2.49245935981746,0.249395189069002
"48055",29504,2519,3364,11351,6269,1275,3344,1382,23621,4726,1.84344225411767,0.132116087444005
"48057",13633,1297,1020,4401,3249,1290,1695,681,11316,2376,3.57583108127506,0.178314172338552
"48059",9768,303,716,3317,2505,738,1677,512,8749,2189,1.89699690484097,0.223476896403998
"48061",248591,42460,33465,64783,42419,18340,32707,14417,172666,47124,4.2695202267318,0.23562206516247
"48063",8187,551,482,2758,1929,604,1284,579,7154,1863,1.27620135378612,0.0507671940759989
"48065",4037,65,237,1302,1040,339,746,308,3735,1054,1.957659374661,0.237423468770995
"48067",20040,787,1832,8624,3886,1438,2394,1079,17421,3473,2.65377937032161,0.240196889779468
"48069",4562,832,246,1475,792,221,756,240,3484,996,1.92420674905616,0.228649583563995
"48071",28532,1306,1713,7403,8615,2667,4598,2230,25513,6828,2.81291087313172,0.152740514851159
"48073",32942,2893,3545,10009,8025,2736,3723,2011,26504,5734,3.47308391672951,0.262084599626999
"48075",4995,235,621,1805,1156,235,731,212,4139,943,1.7069826799418,0.181442073819264
"48077",7471,236,360,2562,2026,560,1265,462,6875,1727,2.44518303272034,0.281485474015242
"48079",1689,386,165,562,270,143,122,41,1138,163,1.76724139003813,0.195055491654272
"48081",2296,191,182,766,548,140,297,172,1923,469,1.95611027836889,0.229151772028004
"48083",5801,458,367,1844,1611,417,815,289,4976,1104,2.66950607164865,0.315993972386507
"48085",685704,21671,20174,100786,125803,50862,230564,135844,643859,366408,1.93206156316252,0.221849808649001
"48087",1879,199,279,434,379,144,359,85,1401,444,1.95082470339369,0.235078985806531
"48089",13936,1034,1145,4986,3052,832,2151,736,11757,2887,2.35302054999926,0.234927179827507
"48091",109308,2796,3963,26139,25507,7615,28221,15067,102549,43288,1.93733095077802,0.1389712790745
"48093",9436,652,712,3042,2375,832,1252,571,8072,1823,2.08776759022555,0.234156084854003
"48095",2502,347,271,944,515,104,221,100,1884,321,2.1622929535943,0.243813307175514
"48097",28011,1547,1844,8911,7139,2395,4220,1955,24620,6175,2.85757760342305,0.226204127244951
"48099",51851,2166,3456,14959,16755,5555,6190,2770,46229,8960,2.05354521267213,0.25959504566001
"48101",1013,47,101,286,314,66,134,65,865,199,2.02131106012896,0.228077896933002
"48103",2884,470,236,1079,519,169,323,88,2178,411,2.32413909605789,0.193150414885481
"48105",2228,52,401,850,515,50,219,141,1775,360,5.01527532462707,0.685027910938513
"48107",3450,362,426,1286,686,190,392,108,2662,500,1.91273868215964,0.226827705703999
"48109",1527,450,104,597,112,1,249,14,973,263,4.0685018373575,0.937181263520648
"48111",4359,962,330,1361,896,125,545,140,3067,685,2.64762302866886,0.391107521188844
"48113",1677755,174466,148955,379095,320326,101994,345945,206974,1354334,552919,1.90869580230332,0.226451634313995
"48115",7793,1091,1181,2576,1427,451,893,174,5521,1067,1.90358776430027,0.224823964628007
"48117",10946,1668,1152,4419,1999,455,889,364,8126,1253,2.62140781597079,0.383077284076373
"48119",3565,124,327,1136,835,347,581,215,3114,796,2.09455367249814,0.0697736704410002
"48121",587191,17977,21601,99340,124730,45697,185968,91878,547613,277846,1.96897286821433,0.2383577040445
"48123",13939,1089,1262,5681,2956,1190,1236,525,11588,1761,2.05945333517281,0.218486552008
"48125",1171,74,116,384,240,121,161,75,981,236,1.91803764807808,0.227886773471489
"48127",5519,1290,444,1793,1125,148,434,285,3785,719,2.32560980544412,0.318437797311493
"48129",2110,75,221,677,651,154,230,102,1814,332,1.96687531934688,0.238507105167998
"48131",6391,1011,755,2134,1554,372,338,227,4625,565,2.7691838109839,0.425410271820004
"48133",12119,796,1021,3526,3069,1115,1695,897,10302,2592,1.98415026180574,0.231186762055003
"48135",96048,9885,12852,28594,21634,7458,10814,4811,73311,15625,1.8933713225664,0.222609924643512
"48137",916,112,86,200,260,66,142,50,718,192,3.3600215864102,0.513386617699001
"48141",530711,63232,44206,126250,118324,47803,88008,42888,423273,130896,2.43063891676638,0.250292596422235
"48139",121350,6490,8766,33040,30790,10402,21736,10126,106094,31862,2.23545397009583,0.236175023849002
"48143",24927,1363,1719,6922,5482,1751,5193,2497,21845,7690,2.1126091486939,0.270057678476005
"48145",12005,855,1606,4022,3095,907,1003,517,9544,1520,1.7961247999497,0.189779279892
"48147",24941,1307,2215,8760,6401,1611,3115,1532,21419,4647,2.22737408195172,0.226153938091639
"48149",17925,918,1145,6953,3550,1229,2974,1156,15862,4130,2.03776661131153,0.232134722862993
"48151",2624,233,124,917,546,290,337,177,2267,514,1.90122877562115,0.224688611786489
"48153",3554,465,471,1053,739,295,379,152,2618,531,2.0067157983633,0.251053336514499
"48155",824,83,117,193,195,96,105,35,624,140,2.33835829016062,0.178812685686997
"48157",518840,25419,21211,93130,92474,37239,148309,101058,472210,249367,2.48612299877487,0.2133622680555
"48159",7150,294,400,1968,1841,562,1426,659,6456,2085,1.35466071152141,0.0738090572114951
"48161",13819,859,1541,4619,3450,1144,1555,651,11419,2206,2.47978549602511,0.219762424458495
"48163",11925,2131,1978,4497,1591,667,484,577,7816,1061,2.11110433214072,0.271679333560996
"48165",11388,3168,1210,3707,1555,526,945,277,7010,1222,2.59090788623293,0.374457644596287
"48167",233519,9187,14495,56847,54084,21302,51790,25814,209837,77604,3.97189625087882,0.099283695315768
"48169",4276,725,720,1385,878,70,301,197,2831,498,1.89780947436619,0.224443802996005
"48171",19525,1141,892,5147,3986,1481,4527,2351,17492,6878,2.15210737466001,0.257908481837501
"48173",831,140,64,152,188,31,196,60,627,256,1.89245343423977,0.222518884461008
"48175",5075,505,321,1459,1333,536,705,216,4249,921,2.14472819138732,0.205412247440008
"48177",12790,1299,1712,5506,1807,730,1190,546,9779,1736,2.1175352757996,0.257724745477499
"48179",14112,1191,1487,4683,3464,1221,1558,508,11434,2066,1.96647394611969,0.238819984262001
"48181",90468,3576,5159,27226,24708,10117,13025,6657,81733,19682,2.35989415914914,0.246375127608204
"48183",80057,4559,6757,22532,22252,6993,11705,5259,68741,16964,1.34539772784444,0.0685197006994992
"48185",20055,1354,2323,6733,4762,1357,2255,1271,16378,3526,2.37192746004086,0.195178171012501
"48187",112207,5091,6929,34022,23606,10343,21021,11195,100187,32216,2.35276564484407,0.172364833566496
"48189",20235,2709,2301,6483,4117,1243,2222,1160,15225,3382,2.01828439276085,0.254141002402
"48191",1993,156,191,657,435,169,275,110,1646,385,1.92727809564255,0.229900815355499
"48193",5679,244,499,2025,1265,417,918,311,4936,1229,1.97929001313914,0.206073934007985
"48195",3238,529,354,921,509,158,640,127,2355,767,1.96466321058615,0.239049072324712
"48197",2471,129,230,913,644,164,271,120,2112,391,1.95049788913631,0.176724680090057
"48199",37970,1266,3119,14979,8196,3292,5424,1694,33585,7118,2.60065482387051,0.2180434366675
"48201",3010456,311182,234665,685095,585144,215181,618971,360218,2464609,979189,3.84419707130888,0.428467033768603
"48203",45639,1676,3773,14955,11851,3743,6614,3027,40190,9641,2.52563962916271,0.227711128411074
"48205",4054,213,355,1439,926,184,567,370,3486,937,2.61722291768613,0.378067574201431
"48207",3809,365,440,1457,673,200,381,293,3004,674,1.91544279314401,0.227952503201004
"48209",142526,5965,7624,32279,32578,8960,35610,19510,128937,55120,1.79904558687348,0.164470022268503
"48211",2283,190,141,815,460,182,390,105,1952,495,1.95342587533853,0.235789844970572
"48213",57715,2633,6116,19387,14600,4471,6953,3555,48966,10508,3.0594073388207,0.234988671089507
"48215",489589,95181,64807,118834,89616,25722,66601,28828,329601,95429,3.24675817556972,0.371071544848759
"48217",24393,1459,2092,8388,5825,2398,2952,1279,20842,4231,2.56685121477644,0.243614244585501
"48219",13555,1497,1682,3584,3188,1298,1577,729,10376,2306,1.92101539026815,0.228618226435997
"48221",43866,1373,2170,12335,11225,3429,8923,4411,40323,13334,1.38826062379168,0.108487978148496
"48223",24606,1182,2220,8558,5494,1996,3609,1547,21204,5156,2.19249322398846,0.198434035445001
"48225",16337,1078,2259,5977,3423,1258,1650,692,13000,2342,3.11447606898178,0.303458692904506
"48227",23675,2035,2571,8037,6177,1608,2184,1063,19069,3247,1.89994746178691,0.224242557885493
"48229",2297,693,463,527,326,94,190,4,1141,194,4.93717540975954,1.123608504135
"48231",65438,2824,5486,22914,15722,4586,9403,4503,57128,13906,2.03584128806307,0.220697215993997
"48233",13650,718,1157,4503,3623,1387,1730,532,11775,2262,1.93585517670589,0.231286613482996
"48235",1069,59,62,281,368,103,167,29,948,196,2.04780260815388,0.257973190605502
"48237",5786,341,722,2212,1315,341,575,280,4723,855,1.93321206360472,0.230578849237506
"48239",9951,813,1120,3289,2460,728,1185,356,8018,1541,2.21276573459117,0.205392728675997
"48241",23050,863,2715,10088,4805,1549,1829,1201,19472,3030,3.67177955620752,0.23654415226151
"48243",1531,123,82,274,531,104,167,250,1326,417,3.43500197398486,0.552149545706342
"48245",170484,12289,13513,54607,42863,14566,22140,10506,144682,32646,2.67641397478532,0.238394229850312
"48247",2551,342,351,930,513,78,249,88,1858,337,2.27145421609312,0.267718997566998
"48249",25008,1993,3273,9377,4923,1535,3004,903,19742,3907,2.42293033701135,0.20587751700699
"48251",115385,5513,10277,40709,26781,8479,15969,7657,99595,23626,1.8306658418856,0.182212176554001
"48253",14588,701,2114,5655,3298,1049,1423,348,11773,1771,1.95239899506958,0.233547158467498
"48255",10128,1139,1384,3751,1744,497,1145,468,7605,1613,1.96645046048798,0.180596801234492
"48257",89311,4579,7565,26567,22596,8186,13890,5928,77167,19818,1.99517822034163,0.200924188484499
"48259",30226,1223,815,4431,6926,2470,8977,5384,28188,14361,1.60373894866502,0.160414520915004
"48261",103,58,26,15,0,0,2,2,19,4,4.31680457204395,0.363324738382669
"48263",433,34,14,103,127,13,65,77,385,142,1.90318074903559,0.225993319964005
"48265",38117,1362,2383,10920,9405,2939,7255,3853,34372,11108,2.5900624761013,0.268297206814501
"48267",3212,157,303,924,776,149,558,345,2752,903,2.47206043898987,0.304452032227988
"48269",166,31,8,59,26,0,36,6,127,42,1.92517950246798,0.22974139201249
"48271",2451,182,185,630,885,160,218,191,2084,409,2.41983857211853,0.328410873988082
"48273",17501,1704,1689,5754,3388,944,2687,1335,14108,4022,3.73063166192676,0.214649260914438
"48275",2295,244,192,715,655,146,218,125,1859,343,2.13082854369044,0.215245062877499
"48283",4603,455,980,2076,612,124,281,75,3168,356,2.3825014582782,0.355980038735497
"48277",34196,1449,2843,11724,8100,3414,4441,2225,29904,6666,2.51568899756747,0.234934730813692
"48279",8293,1106,862,2981,1616,679,803,246,6325,1049,2.03073455815535,0.257410696989512
"48281",15246,494,818,4729,4524,1907,1824,950,13934,2774,1.9949330844895,0.174836426462494
"48285",13966,1076,835,5530,2963,1064,1860,638,12055,2498,1.92499442726661,0.233581945306503
"48287",12309,819,768,4960,3097,906,1215,544,10722,1759,2.11638441272924,0.154038045777499
"48289",11177,773,1084,4034,2754,608,1256,668,9320,1924,2.85645507547371,0.265152474686506
"48291",57429,5208,7394,22359,13497,3307,4234,1430,44827,5664,2.33768165186429,0.285311659949507
"48293",15444,953,1441,5395,3971,1262,1679,743,13050,2422,1.94046256209568,0.229554419882505
"48295",1897,139,129,568,431,147,380,103,1629,483,1.97912093018687,0.242187605902012
"48297",8089,676,1210,2570,2236,363,703,331,6203,1034,2.30385510147408,0.257177536338498
"48299",16778,430,1392,4424,4246,1118,3555,1613,14956,5168,2.31789468286334,0.235586884847999
"48301",52,0,3,9,15,25,0,0,49,0,2.13445945037047,0.166952035763661
"48303",182979,9392,12800,47375,41575,13042,36558,22237,160787,58795,1.91228699480697,0.226647779577999
"48305",3627,268,492,1035,759,235,602,236,2867,838,1.90156750025283,0.223674440237991
"48313",9356,513,1519,3674,1975,568,757,350,7324,1107,1.91230526256224,0.115502170309502
"48315",7105,213,710,2825,1618,649,871,219,6182,1090,1.9982068236234,0.104816841311302
"48317",3080,356,237,1028,712,100,360,287,2487,647,1.91273580890486,0.227068649157499
"48319",2724,229,251,557,563,172,715,237,2244,952,1.92352648335453,0.227312430095505
"48321",23814,2649,1785,7060,5920,1688,2999,1713,19380,4712,2.9381192798354,0.331017679506541
"48323",32988,6775,5248,8684,5031,1973,4092,1185,20965,5277,2.84466512886872,0.309049455622038
"48307",5441,483,578,1796,1428,393,462,301,4380,763,2.4271637779414,0.263168590235999
"48309",157430,8604,12807,42373,35473,16795,26064,15314,136019,41378,2.08879386499732,0.260849959459996
"48311",481,23,26,224,107,27,43,31,432,74,2.11516349379914,0.275598784294999
"48325",34068,2102,2728,10919,7727,2896,4558,3138,29238,7696,2.49199081585948,0.321137539435498
"48327",1513,118,153,385,326,120,231,180,1242,411,2.01728913984873,0.220431442695999
"48329",103892,7252,8834,25181,24047,8687,21073,8818,87806,29891,1.89383032525085,0.222643919821503
"48331",16858,1073,1276,6905,3435,1437,1884,848,14509,2732,2.30491852335876,0.249167716588992
"48333",3386,247,250,1047,757,247,565,273,2889,838,2.42663112101328,0.184335879279002
"48335",5329,402,544,2307,1182,365,443,86,4383,529,1.91335884635484,0.227257205430503
"48337",13971,692,1197,5129,3383,1125,1734,711,12082,2445,2.13612069738729,0.236311983414525
"48339",397841,17328,24055,91933,89606,30207,96934,47778,356458,144712,2.57597479445413,0.261560684636995
"48341",12544,2882,1244,3914,2069,811,1154,470,8418,1624,1.94998194045095,0.235006947593504
"48343",8216,358,469,3450,2330,553,581,475,7389,1056,1.4626405394743,0.0647419942299981
"48345",917,42,81,268,254,74,154,44,794,198,2.00415781866,0.250411270288005
"48347",37632,2708,2813,11478,9214,2125,5831,3463,32111,9294,3.57887710590317,0.241502540376494
"48349",33635,3185,3482,10106,8474,2788,3795,1805,26968,5600,2.46563767434539,0.268610462289001
"48351",8801,424,1154,3794,2055,644,567,163,7223,730,3.23659679121498,0.229343005470955
"48353",9490,617,1060,3134,2356,775,1052,496,7813,1548,1.9079150449739,0.226517446934994
"48355",231467,15803,20984,67992,55803,20090,33012,17783,194680,50795,4.05396950280751,0.206463310688303
"48357",6027,784,623,2018,1085,382,760,375,4620,1135,1.96281034651179,0.238533977546995
"48359",1313,95,70,411,292,132,236,77,1148,313,2.63754053045224,0.385753045091329
"48361",56948,1367,4922,20535,14360,6217,7058,2489,50659,9547,1.79524157521575,0.0920208515609933
"48363",19356,1038,1505,7074,4650,1707,2224,1158,16813,3382,2.01338944454562,0.245562483026998
"48365",15336,736,1921,4633,4537,1437,1542,530,12679,2072,2.04295685569995,0.203414939562552
"48367",97778,3760,6346,26714,22264,10408,18408,9878,87672,28286,1.91233619010981,0.226859439523501
"48369",6223,1124,538,1638,1146,656,844,277,4561,1121,1.90448425435835,0.225053017047015
"48371",10140,1242,1296,3821,2180,437,717,447,7602,1164,5.95400732559206,1.16281003151748
"48373",35680,2396,4603,13350,8369,2301,3269,1392,28681,4661,2.74853389157735,0.270835519846005
"48375",75585,8892,8877,23774,16264,5816,8403,3559,57816,11962,1.95851372496425,0.236935807687994
"48377",4045,1667,271,523,534,331,478,241,2107,719,5.22058472243211,0.933656597657772
"48379",8928,599,619,3255,2172,601,1112,570,7710,1682,1.29598291941434,0.0645932456525034
"48381",91893,1745,4027,21697,25723,9091,19956,9654,86121,29610,1.95554179524522,0.235879726023504
"48383",1928,79,207,835,405,137,162,103,1642,265,2.15318113068071,0.288694512326993
"48385",1981,125,88,753,490,208,217,100,1768,317,1.86013684451142,0.169255553427506
"48387",8599,369,683,3552,2067,661,864,403,7547,1267,3.33160054568753,0.266034422932725
"48389",9712,1439,1428,3727,1653,538,674,253,6845,927,4.47726515312837,0.64844123869902
"48391",4725,305,582,1916,1068,363,343,148,3838,491,3.03632702142413,0.187192199668175
"48393",560,0,36,189,119,71,86,59,524,145,1.96701967989684,0.238592044181996
"48395",11461,584,1142,4392,2411,889,1345,698,9735,2043,2.46068689434976,0.21183302838
"48397",68621,1816,2602,12321,15315,6527,19174,10866,64203,30040,0.778807689920364,0.0371763097150003
"48399",6826,616,531,2424,1579,473,886,317,5679,1203,2.03917913237148,0.260816240627993
"48401",36031,2089,3481,11939,9402,3370,3733,2017,30461,5750,2.36854745821165,0.232269300597003
"48403",7582,282,751,2660,1824,663,806,596,6549,1402,1.98654350629111,0.141584638516376
"48405",5802,352,746,2508,1248,248,428,272,4704,700,2.38383372171357,0.145464497634498
"48407",19279,1089,1901,7535,5099,894,1677,1084,16289,2761,2.16898650376451,0.152927934481496
"48409",44274,3714,4364,14265,10983,3605,4873,2470,36196,7343,2.89381334015626,0.167698342218987
"48411",3955,362,364,1514,832,212,554,117,3229,671,3.10520351179124,0.278932974731499
"48413",1718,136,123,486,585,100,214,74,1459,288,2.44547891155267,0.320117156525998
"48415",10992,1059,1028,3600,2701,872,1285,447,8905,1732,1.90609421436806,0.226136474630005
"48417",2151,61,142,478,633,131,486,220,1948,706,1.91659552661481,0.228097952769495
"48419",15794,1304,1750,5595,4005,899,1663,578,12740,2241,2.3313106530509,0.205870566169169
"48421",1581,253,196,351,342,119,238,82,1132,320,1.96746448433635,0.239783554337526
"48423",152001,8071,10721,36697,38749,15248,28380,14135,133209,42515,2.7860403322089,0.235704647609442
"48425",6443,176,513,2104,1435,399,1346,470,5754,1816,0.912965918296458,0.0475493386869969
"48427",36467,9602,5439,9651,6060,1239,3349,1127,21426,4476,2.58370209184145,0.288164495065703
"48429",6246,430,516,2149,1578,411,882,280,5300,1162,1.92173709052843,0.229588614190999
"48431",805,28,33,375,202,16,94,57,744,151,1.9463640873032,0.227802162265493
"48433",798,52,72,306,232,19,84,33,674,117,1.92922340559343,0.230511039192514
"48435",2145,229,266,730,423,86,259,152,1650,411,2.52695943951928,0.353830710896504
"48437",4639,644,614,1586,794,244,609,148,3381,757,1.92372566236761,0.229108513843994
"48439",1346743,84425,95345,318869,293057,105322,299714,150011,1166973,449725,1.90671829153193,0.225276937184
"48441",86717,3373,5858,25623,20226,7476,15084,9077,77486,24161,1.91713999527472,0.227973861859005
"48443",810,68,42,221,285,27,131,36,700,167,3.82535556267612,0.572249948512937
"48445",7374,1108,885,2344,1862,310,576,289,5381,865,1.89739606417759,0.223061530886999
"48447",1005,50,40,352,253,77,167,66,915,233,1.92157047522846,0.229244420635002
"48449",19148,2197,1790,7143,3267,1512,2405,834,15161,3239,1.81986472238587,0.106624133463006
"48451",76407,4289,5311,22547,19487,5597,13025,6151,66807,19176,3.51179060084044,0.378497974849998
"48453",881650,46530,36041,138636,146979,48841,291336,173287,799079,464623,2.46168498200135,0.249038982408995
"48455",9957,521,1082,3886,2546,592,972,358,8354,1330,2.20380006696517,0.174835887177496
"48457",14320,862,1801,5639,3306,599,1529,584,11657,2113,2.6278787480921,0.228349966195997
"48459",27899,1308,2722,9453,7146,2450,3539,1281,23869,4820,1.78653869889992,0.147658729394998
"48461",2226,300,233,812,466,149,174,92,1693,266,2.20447326473508,0.304683517219004
"48463",15367,2046,1830,4537,2795,1328,2157,674,11491,2831,2.47116050654053,0.375187616429005
"48465",28831,5177,3210,7410,5102,2291,3438,2203,20444,5641,4.40529791453365,0.782006980083127
"48467",40911,1970,3704,13189,11269,3545,5160,2074,35237,7234,2.32747372350822,0.213776344113498
"48469",59682,4051,5715,18268,14070,6027,8114,3437,49916,11551,2.71866145527992,0.212747504218001
"48471",49766,2802,4237,19393,10164,3186,6702,3282,42727,9984,2.09121356965966,0.195529842816496
"48473",31206,1856,2039,9556,8341,1546,5320,2548,27311,7868,2.4438235293866,0.125417636856503
"48475",7123,744,772,2509,1869,454,616,159,5607,775,2.83105783386034,0.2055655570715
"48477",23789,1046,1541,7633,4985,1909,4374,2301,21202,6675,2.51084763357826,0.150883982878502
"48479",149469,25192,21411,35298,27203,11324,20534,8507,102866,29041,4.75331902984095,0.800551921880568
"48481",26802,2264,2955,7812,6213,2567,3476,1515,21583,4991,2.44327641910399,0.263136086868493
"48483",3405,298,337,1154,775,247,490,104,2770,594,1.95099865098832,0.235181711572622
"48485",82903,3641,6232,27245,19629,7031,12514,6611,73030,19125,1.84664921951405,0.159880411092792
"48487",8727,768,1103,2893,2044,582,1005,332,6856,1337,2.4599663163812,0.247422112344706
"48489",12984,2275,1810,4925,2114,614,830,416,8899,1246,2.47814706973646,0.148002601625191
"48491",395349,11408,12289,73860,85686,34979,115187,61940,371652,177127,2.48035617893982,0.275863904250001
"48493",33556,1723,1856,11016,8094,2809,5764,2294,29977,8058,1.91674712558671,0.194171686738512
"48495",4630,596,713,1399,1147,305,387,83,3321,470,1.92613307944154,0.20748826070375
"48497",45709,2659,3796,15481,11396,3826,6120,2431,39254,8551,1.93406958308208,0.231125171175002
"48499",32318,1693,2782,10398,8455,2387,4066,2537,27843,6603,2.14921157836985,0.173439642826058
"48501",4691,852,419,1390,1276,249,447,58,3420,505,1.79057811901522,0.200289978589528
"48503",12424,617,1029,3914,2972,702,2238,952,10778,3190,1.94160497695811,0.233032492166503
"48505",7879,1355,1147,2573,1420,445,826,113,5377,939,2.24583967383768,0.249104143846612
"48507",5883,814,623,1844,1248,485,527,342,4446,869,2.29216930018853,0.311716440821514
"49001",4069,96,281,1120,987,496,892,197,3692,1089,4.26511003015151,0.689841514387194
"49003",33905,668,1461,10863,9431,3199,6081,2202,31776,8283,6.18591033022998,1.88030442336799
"49005",67191,1676,2246,13757,18153,5141,16917,9301,63269,26218,3.02337447364829,0.328708612857914
"49007",13117,361,757,3827,3878,2107,1396,791,11999,2187,3.6549552228261,0.403553209726003
"49009",353,2,13,129,114,27,48,20,338,68,2.88797903954954,0.199381331838463
"49011",211179,2896,6219,44724,55054,21939,53893,26454,202064,80347,2.23530038374666,0.176108934272491
"49013",11589,242,944,4669,2960,1091,1214,469,10403,1683,3.95845294908974,0.891691251978497
"49015",6207,89,268,1947,1958,1006,578,361,5850,939,6.355400593539,1.204337763355
"49017",3526,53,117,1154,825,490,596,291,3356,887,6.80657725041716,1.38121101765747
"49019",7053,114,326,2040,1850,827,1153,743,6613,1896,5.32716829049435,0.992198715667585
"49021",31347,664,1426,7539,9234,3328,6266,2890,29257,9156,4.57226448345142,0.875209644694137
"49023",6550,102,388,2241,1709,730,864,516,6060,1380,6.77189115918966,0.926355117003205
"49025",5599,94,315,1421,1469,613,1159,528,5190,1687,5.99373834694307,1.08096702288565
"49027",7821,260,543,2582,1815,782,1456,383,7018,1839,6.09870886641331,1.84350514571578
"49029",6795,57,90,1298,1763,892,1711,984,6648,2695,2.79923939017814,0.169552634016499
"49031",1259,49,87,426,288,154,189,66,1123,255,2.39302804255118,0.204488578472498
"49033",1486,20,27,383,514,195,256,91,1439,347,3.02529143592947,0.30406963350154
"49035",746749,23521,37708,166397,173708,68178,178208,99029,685520,277237,2.39045747506694,0.222241049306503
"49037",8833,535,653,2496,2344,988,1188,629,7645,1817,8.69466316862833,2.09719383434113
"49039",17140,545,999,5206,4665,1788,2461,1476,15596,3937,3.235366414498,0.433695769925505
"49041",13534,275,759,4366,3776,1408,1990,960,12500,2950,3.57224989721639,0.51481951976799
"49043",28465,646,767,4571,5302,1475,9905,5799,27052,15704,5.05344896680955,0.520548760099121
"49045",41796,834,2353,13159,11420,4410,6103,3517,38609,9620,6.07804237147212,2.00308998233735
"49047",20935,383,2217,7385,5655,1672,2723,900,18335,3623,5.38208896985253,1.23260283982719
"49049",325810,5911,9972,54886,83436,33825,95656,42124,309927,137780,5.02066420726423,0.586823571792497
"49051",20573,431,380,4128,4749,1782,5900,3203,19762,9103,3.33053712175883,0.331485460470515
"49053",115393,2628,4650,25231,31816,15871,22042,13155,108115,35197,3.59150299630293,0.639577141058352
"49055",1768,8,139,440,510,286,307,78,1621,385,4.90048929791675,0.658194699799523
"49057",161818,4505,8733,47226,43512,15292,29801,12749,148580,42550,2.93982858528335,0.183648240437494
"50001",25986,372,1103,7605,3859,2066,6580,4401,24511,10981,2.40908022957016,0.234770045762
"50003",26579,486,1107,7289,5174,2290,5898,4335,24986,10233,2.22139666489634,0.193654731157047
"50005",21776,438,1117,7437,4301,1761,4203,2519,20221,6722,2.73947780373848,0.192614718847552
"50007",111176,1918,3626,19982,15758,9729,35335,24828,105632,60163,2.13928160987223,0.181767491795715
"50009",4557,88,379,2027,763,393,520,387,4090,907,2.92761080047252,0.198192965063218
"50011",34884,1117,1775,13022,6174,3270,6209,3317,31992,9526,2.09931054759917,0.203195172553035
"50013",5478,72,212,1640,760,471,1416,907,5194,2323,1.33161519613626,0.0569560276273211
"50015",18235,266,943,4519,3261,1501,4951,2794,17026,7745,1.80645972531789,0.136857328681998
"50017",21625,495,893,7347,3317,2172,3866,3535,20237,7401,2.29489810786456,0.201033559452404
"50019",20010,610,1147,7487,3491,1815,3316,2144,18253,5460,2.31336560123113,0.212869451282864
"50021",44319,779,2001,14999,8043,4284,8979,5234,41539,14213,2.81927147901639,0.272877488887266
"50023",42659,658,1643,11185,7065,3343,10817,7948,40358,18765,2.25540867504946,0.203022444585495
"50025",33997,348,1801,10352,5404,2204,7895,5993,31848,13888,2.38215036517988,0.228370521436767
"50027",43182,622,1899,12237,7396,3665,10015,7348,40661,17363,3.33658555858212,0.281838097581274
"51001",24436,1451,2880,8485,4586,1901,2953,2180,20105,5133,3.49652582276592,0.149170790567005
"51003",75879,1675,3394,11146,10704,4256,22930,21774,70810,44704,2.32800156674515,0.192926442309995
"51510",119887,4953,3260,12509,14608,6410,37240,40907,111674,78147,0.336913433640117,0.00413894794311162
"51005",11228,414,787,4726,2548,1035,1030,688,10027,1718,2.09470894619614,0.119175555059655
"51007",9591,633,762,4213,1598,688,1174,523,8196,1697,1.80122874226174,0.0944402011835014
"51009",22673,915,1883,8678,4057,2194,3052,1894,19875,4946,1.87300854552381,0.1265700995255
"51011",11353,463,798,4362,2482,1034,1629,585,10092,2214,1.36075152775311,0.0883279360185019
"51013",173477,5830,3030,12874,13549,5824,61200,71170,164617,132370,0.400958948759223,0.0069949900331079
"51015",56608,2073,3903,23102,10731,4021,8394,4384,50632,12778,3.13401988775101,0.258452424760173
"51017",3334,250,245,1260,656,302,442,179,2839,621,1.8324061774641,0.142127084738604
"51019",57492,1398,3011,17112,12774,5395,10745,7057,53083,17802,2.6740237949651,0.204356598959001
"51021",4931,155,392,2227,1037,462,433,225,4384,658,1.84740930798544,0.0942033188369551
"51023",24740,650,881,8651,4702,3083,4192,2581,23209,6773,1.9313653857234,0.144198330728498
"51520",12292,316,1309,3797,2941,1049,1451,1429,10667,2880,0.497943964075014,0.0033835298082237
"51025",11861,668,1893,4238,2292,859,1132,779,9300,1911,1.60668336462723,0.148842090406121
"51027",15564,1639,2451,5991,2618,1099,842,924,11474,1766,2.14888584043536,0.132567912452018
"51029",12618,1078,1341,5746,2351,619,892,591,10199,1483,1.95662958262399,0.154177887684498
"51530",4094,235,590,1398,833,240,417,381,3269,798,0.270102484360616,0.00172472886700027
"51031",40115,1516,2723,13623,9347,3272,6359,3275,35876,9634,2.06831383147342,0.133220433203
"51033",21121,724,1670,8134,4336,1614,3083,1560,18727,4643,2.32833470110166,0.142727333432499
"51035",21881,1897,2139,8205,3730,2588,2325,997,17845,3322,1.77595415652493,0.124826810305623
"51036",5354,213,703,2132,1094,378,612,222,4438,834,1.48637494919078,0.0527547277645846
"51037",8156,405,860,3024,1726,907,747,487,6891,1234,1.9406261812758,0.1252179556735
"51540",30077,840,1451,4769,4059,1521,8488,8949,27786,17437,0.368654153838934,0.00272088098000089
"51550",166277,3484,7323,39115,40445,16906,36981,22023,155470,59004,1.4513669192804,0.0916180926704484
"51041",242701,7610,10419,55077,48066,21161,62065,38303,224672,100368,2.29111119176156,0.1151257907735
"51043",10755,268,627,3104,2046,923,2296,1491,9860,3787,1.03939178508971,0.0480513262148389
"51570",12731,464,608,4130,3111,1115,1952,1351,11659,3303,0.277542730850454,0.00205227952300043
"51580",4076,96,353,1931,837,296,332,231,3627,563,0.221243440426385,0.00149883281099947
"51045",3516,140,260,1324,700,363,525,204,3116,729,1.53524479660174,0.0868361647390707
"51047",35013,1351,2544,11432,7324,3071,5917,3374,31118,9291,2.09943762361635,0.1023475324575
"51049",7228,349,516,2698,1636,775,669,585,6363,1254,1.4526182173093,0.0791176640215006
"51590",29594,1519,3163,10937,5975,2642,3206,2152,24912,5358,0.710464765081879,0.0114181088832295
"51051",10547,887,1225,4245,2112,981,886,211,8435,1097,1.33236997752083,0.087611603071443
"51053",19877,756,1490,7719,4295,2124,2136,1357,17631,3493,1.71195212627141,0.133125730236499
"51595",3832,382,590,1320,733,334,278,195,2860,473,0.218403804929098,0.00181162353499924
"51057",7678,380,798,2875,2054,353,864,354,6500,1218,1.85655281008427,0.0709969635833883
"51059",781797,28414,23460,96148,93173,43935,246862,249805,729923,496667,2.14003788947722,0.108024877414898
"51600",16355,512,664,2210,1867,1064,4967,5071,15179,10038,0.229544503367231,0.00168973253600118
"51610",9760,149,113,639,947,231,2888,4793,9498,7681,0.126236360469936,0.00055020151650007
"51061",49983,1371,2208,12804,10930,3829,11764,7077,46404,18841,2.28934387444356,0.174885648500499
"51063",11622,481,658,4469,2024,1532,1507,951,10483,2458,1.8657823427311,0.100000757547998
"51065",19973,290,1011,4623,5038,1767,4575,2669,18672,7244,1.12711521217335,0.0771650358025018
"51067",39915,1658,2680,13639,8962,3970,5723,3283,35577,9006,2.36148060775346,0.186554392386002
"51620",5769,267,670,1709,1320,589,695,519,4832,1214,0.289199142888367,0.00218313852349947
"51069",62627,3008,4287,19835,13095,5115,9992,7295,55332,17287,2.31763265293195,0.112172223220468
"51630",16896,797,714,3546,3769,859,3868,3343,15385,7211,0.281795325802266,0.00280216915449948
"51640",4555,356,616,1197,1162,410,488,326,3583,814,0.313429941692519,0.0021625207945014
"51071",12199,449,782,4678,2947,1081,1444,818,10968,2262,1.63299061397309,0.0951822001831999
"51073",28221,880,2102,8119,7272,2712,4487,2649,25239,7136,1.6192625516954,0.0654390040649956
"51075",18322,436,662,3961,3437,1385,4643,3798,17224,8441,1.77003003792665,0.0769423238454978
"51077",11652,726,1294,4374,2114,1326,1322,496,9632,1818,2.07049832862897,0.116294198669646
"51079",14115,553,1087,4265,2969,1206,2459,1576,12475,4035,1.1615887918655,0.0417672199885006
"51081",8814,562,1448,3591,1760,490,616,347,6804,963,2.09188383240513,0.0774906875853807
"51083",24723,1790,2480,9024,4966,2419,2551,1493,20453,4044,2.50553453021516,0.216900407819356
"51650",91658,2202,4615,26702,23072,10031,15189,9847,84841,25036,0.679541762589777,0.0154292628292612
"51085",75856,1596,3098,19113,15077,6217,19555,11200,71162,30755,2.56302792516224,0.125129458089005
"51660",26548,2273,2143,7029,3960,1971,5230,3942,22132,9172,0.365815254089765,0.00465128445600143
"51087",231190,6639,10202,50538,43464,16430,61445,42472,214349,103917,2.08668755486133,0.0646541522404993
"51089",37437,2834,4328,12836,7531,4237,3628,2043,30275,5671,1.81866439526166,0.100368600733234
"51091",1688,54,79,686,341,54,302,172,1555,474,1.6140246522161,0.111060022933062
"51670",15135,607,1632,5905,3571,1694,1237,489,12896,1726,0.298158799138859,0.00284861436849942
"51093",27469,608,1875,8090,6265,2628,4931,3072,24986,8003,1.84662179410476,0.0844492959352989
"51095",56345,862,1628,10888,9574,4950,14767,13676,53855,28443,1.68846096104032,0.0411090597473685
"51097",5240,154,461,1988,1081,441,834,281,4625,1115,2.33086290170251,0.0863691405384996
"51099",17651,490,871,5015,3844,1270,3648,2513,16290,6161,1.33842176112764,0.0496610801791153
"51101",12078,263,633,4002,3045,1125,2240,770,11182,3010,2.55846389970603,0.0756617248620004
"51103",8688,308,569,2699,1520,695,1541,1356,7811,2897,1.29037642186388,0.0379339615984534
"51105",16969,1611,1817,5998,4651,1061,1421,410,13541,1831,2.15841645703226,0.11422248592032
"51678",3188,47,66,646,365,135,955,974,3075,1929,0.140048165735651,0.00066795409599968
"51107",266804,7867,7965,30890,35836,16218,93921,74107,250972,168028,1.91047125901544,0.140551437446735
"51109",27131,995,1945,9540,5567,2078,4184,2822,24191,7006,1.93381506658642,0.1353648177015
"51111",8702,574,1190,3413,1903,599,683,340,6938,1023,1.65938121552681,0.113277520141
"51680",44230,1657,2843,10521,8537,3742,9968,6962,39730,16930,0.641194324554961,0.013054734079001
"51113",10001,410,826,3537,2041,720,1433,1034,8765,2467,1.52926683878403,0.0859872296394991
"51683",27684,2099,1821,7710,4813,2352,5337,3552,23764,8889,0.333315126997759,0.00265279745700031
"51685",11188,1409,877,3162,1819,1056,2037,828,8902,2865,0.207634490881691,0.00081463678849973
"51690",8909,398,642,2729,1809,1360,1323,648,7869,1971,0.288981107407904,0.00287596010449998
"51115",6437,137,337,1869,1538,632,1409,515,5963,1924,0.94720169096527,0.0258882498055309
"51117",22521,1206,1842,7779,4271,2390,3197,1836,19473,5033,2.31940256805469,0.177383149952872
"51119",8438,385,632,2470,1806,856,1441,848,7421,2289,1.40458164168229,0.036908789186598
"51121",56661,856,2438,13305,10309,3746,12148,13859,53367,26007,1.89205566856323,0.102302828752002
"51125",11151,490,1239,3672,1690,683,1911,1466,9422,3377,2.12331643363628,0.1256071685155
"51127",16472,239,868,4926,3799,1243,3673,1724,15365,5397,1.84448471098268,0.0590635408004994
"51700",120142,3323,6816,34662,28919,12636,21056,12730,110003,33786,0.976978828282482,0.0184957565169978
"51710",149872,4764,11931,36088,36414,13012,28751,18912,133177,47663,0.63834398552446,0.0162173523063771
"51131",9091,555,730,2874,1694,685,1562,991,7806,2553,1.64651004847116,0.0912188472448405
"51133",9307,327,566,2696,1600,967,1868,1283,8414,3151,1.5372952725506,0.0561929282234895
"51720",2666,145,155,874,679,230,329,254,2366,583,0.307669857966854,0.00196686150900052
"51135",11278,674,1205,4335,2286,937,1343,498,9399,1841,1.43628651515705,0.0829943715754971
"51137",25620,895,1764,9322,5275,1672,4156,2536,22961,6692,1.86474623251825,0.0915834174584969
"51139",17368,1029,1920,7928,3110,844,1468,1069,14419,2537,1.39387758819286,0.083921324997499
"51141",13575,913,1367,4835,2699,1535,1537,689,11295,2226,1.91502831065031,0.12688636096111
"51730",23015,1381,2105,7877,4867,1713,3153,1919,19529,5072,0.393758344537832,0.0060275354814985
"51143",45116,2572,4622,17025,10061,4410,4513,1913,37922,6426,2.89973781530699,0.255946846592023
"51735",8727,161,225,2204,1760,807,1849,1721,8341,3570,0.365643751325351,0.00534873868558129
"51740",65616,1670,4732,20822,18082,6544,8816,4950,59214,13766,0.506489724099248,0.0102823417078714
"51145",22572,430,1520,6749,4796,2064,4845,2168,20622,7013,1.46665776611553,0.0692704733599992
"51147",12562,703,1095,4315,2752,557,1923,1217,10764,3140,1.67411037047398,0.0930486626605015
"51149",29158,878,2409,8799,7123,2834,5036,2079,25871,7115,1.65311634262283,0.0740996680585013
"51153",306248,17529,14242,61443,57742,24389,76944,53959,274477,130903,2.27070478586689,0.0918415538182511
"51155",25477,925,1771,8548,6279,2948,2945,2061,22781,5006,1.54383741050283,0.0864445305835009
"51750",7473,283,298,1492,1843,535,1482,1540,6892,3022,0.322880798325159,0.00262935088550027
"51157",5617,188,276,1799,1108,458,1021,767,5153,1788,1.33500483331206,0.0716430654530004
"51159",6875,459,1066,2228,1274,647,697,504,5350,1201,1.33488607608899,0.0522982864617417
"51760",159960,7525,12092,32708,30685,8030,40123,28797,140343,68920,0.843543950030104,0.0165120180230003
"51161",69624,1680,2841,18838,13250,6970,16986,9059,65103,26045,2.19104596075865,0.0661016057950012
"51770",69949,2655,5547,23913,13280,5803,11430,7321,61747,18751,0.674193981158552,0.011276522806501
"51163",16999,635,1203,6033,3212,1126,2721,2069,15161,4790,2.32705361791163,0.159027697912999
"51165",57112,3288,4593,20893,8614,3914,9429,6381,49231,15810,2.66761871288416,0.228468421353284
"51167",19239,1779,1731,7394,3918,2075,1669,673,15729,2342,1.97730238243465,0.124817395490998
"51775",17155,394,771,4744,3461,2269,3272,2244,15990,5516,0.356667182819421,0.00384354714899945
"51169",16087,1360,1536,5885,3285,1761,1485,775,13191,2260,1.79697494619706,0.140775115448775
"51171",31549,1201,2273,12723,6089,2826,3949,2488,28075,6437,2.05906265451221,0.137574016185644
"51173",21943,1291,2185,8618,4093,2253,2294,1209,18467,3503,1.64839224093831,0.118454412454499
"51175",13389,656,1285,4224,3503,1139,1684,898,11448,2582,2.42202257698163,0.157384467929996
"51177",92722,2459,5348,25127,21367,7403,19008,12010,84915,31018,1.75379306624988,0.110333193386
"51179",98973,2619,4105,21840,20485,8050,25522,16352,92249,41874,1.38326045600733,0.0745033731818788
"51790",18231,419,1103,5904,3759,1518,3241,2287,16709,5528,0.314063674418866,0.00531090995049981
"51800",63420,2220,3609,16781,15299,5858,11843,7810,57591,19653,1.61274162253233,0.108724417715902
"51181",4950,213,511,1589,1163,354,828,292,4226,1120,1.51877915656633,0.0743793011184134
"51183",8133,467,1173,3278,1651,491,742,331,6493,1073,1.84312183714166,0.129067622803005
"51185",29512,2085,2393,11030,6039,3170,3076,1719,25034,4795,2.1499863069729,0.136489799879375
"51810",314320,5342,12097,65299,75702,34498,76292,45090,296881,121382,1.45789243633781,0.0801311165403215
"51187",28140,1080,2206,9632,6766,2130,4066,2260,24854,6326,1.28352104906903,0.0586151133695002
"51191",40117,1965,2893,13818,7606,3946,6288,3601,35259,9889,2.1601539232256,0.147947609415176
"51820",15543,861,1057,5511,2695,1077,2724,1618,13625,4342,0.326037314358706,0.00401461574449967
"51193",13723,820,1464,5457,2715,998,1358,911,11439,2269,1.70511621050748,0.0648464895971272
"51830",7962,193,336,1613,1168,636,2144,1872,7433,4016,0.321234928501867,0.0023935977294993
"51840",18830,977,1419,4992,3866,1231,3798,2547,16434,6345,0.238485290712512,0.00248121429300036
"51195",26203,1954,3768,8859,5130,2665,2342,1485,20481,3827,2.18567718402426,0.106298861844905
"51197",20831,732,1590,7726,4415,2283,2410,1675,18509,4085,1.61419892636903,0.121708852813661
"51199",47176,829,1416,8345,8988,4700,12505,10393,44931,22898,1.25371827436252,0.0328102928305043
"53001",11073,2584,905,3397,1908,760,879,640,7584,1519,3.86945040966254,0.591085468169
"53003",16112,235,1129,4527,4341,2064,2448,1368,14748,3816,2.12166191399895,0.193350160564739
"53005",132817,6392,6484,30781,32098,14390,25915,16757,119941,42672,3.25534681275744,0.531798034293653
"53007",53696,4267,3932,13235,11761,5166,9810,5525,45497,15335,6.13191227761927,0.932364600785996
"53009",59074,1200,3006,14746,15721,6668,10682,7051,54868,17733,5.04659763650768,0.553965554950639
"53011",338510,7344,16334,84308,85885,36451,69721,38467,314832,108188,2.11275800493994,0.196486103581831
"53013",3047,99,174,614,983,360,485,332,2774,817,2.57241839658547,0.26416973296728
"53015",76176,2472,5195,23635,22761,9153,8627,4333,68509,12960,2.98953826874012,0.352082609509891
"53017",28156,2837,2208,8301,6520,2323,4006,1961,23111,5967,4.52158735607227,0.5741761737405
"53019",5487,132,406,1838,1574,554,633,350,4949,983,4.16560173863339,0.711230982299605
"53021",55250,8093,5206,13941,11766,5307,6917,4020,41951,10937,3.39833138122096,0.384182740271496
"53023",1664,17,83,394,509,238,249,174,1564,423,2.57336370825851,0.217646846208399
"53025",59904,6697,5133,16807,14135,6304,7761,3067,48074,10828,4.73066168199449,0.858361146640497
"53027",54397,1643,3733,19067,14351,6726,5553,3324,49021,8877,4.72058833257345,0.594764746696128
"53029",62604,796,2046,13698,17261,6909,13079,8815,59762,21894,3.23859102754502,0.0664198428676666
"53031",27383,139,918,5832,6586,2213,6556,5139,26326,11695,6.36942194337596,0.567611230485692
"53033",1608743,52589,49272,238797,271838,127100,513580,355567,1506882,869147,5.67476643045993,0.677522065749047
"53035",191555,2617,6564,40579,53399,21323,43745,23328,182374,67073,2.44728856212813,0.134360948917074
"53037",27206,542,1531,6832,6255,2436,6347,3263,25133,9610,4.92743114420361,0.716142323504001
"53039",16786,627,955,4497,3899,1587,3082,2139,15204,5221,4.20189401649279,0.57162086177657
"53041",57626,2059,4129,17339,15952,7183,6999,3965,51438,10964,5.10225148245336,0.740529272752011
"53043",7696,140,453,2104,2281,847,1230,641,7103,1871,3.92855998301237,0.724275535319003
"53045",47485,1418,3138,14632,13301,6104,6002,2890,42929,8892,3.76262409225303,0.308609981688505
"53047",29575,2197,2255,8535,7218,3104,4000,2266,25123,6266,7.16223512079636,1.67629387130607
"53049",18066,570,1177,5286,5318,1674,2690,1351,16319,4041,3.94477217587585,0.286849054597703
"53051",9699,149,551,3103,2699,1049,1424,724,8999,2148,3.09635489702969,0.449524780303358
"53053",615128,16067,32677,162800,156372,72452,113875,60885,566384,174760,6.33171900566082,0.520533198727214
"53055",14457,176,444,2372,3104,948,4217,3196,13837,7413,4.90954603714842,0.0609158681706921
"53057",90674,3359,4703,23151,23413,10076,16506,9466,82612,25972,6.66995941310935,0.554361408503181
"53059",9048,131,517,2891,2342,826,1385,956,8400,2341,3.22721336277817,0.507442983858051
"53061",572584,15270,25606,133217,140675,62517,131050,64249,531708,195299,4.59856894169683,0.659641602552341
"53063",364983,6681,14633,84675,95590,48381,73808,41215,343669,115023,3.29312032182841,0.551875038783161
"53065",33122,660,1870,11419,8581,3691,4065,2836,30592,6901,5.28430522791457,0.799037079259724
"53067",205153,4035,7897,44636,51955,22388,45884,28358,193221,74242,3.0054186399762,0.23259303798939
"53069",3390,57,188,1008,875,540,423,299,3145,722,1.46204548289957,0.083601035680106
"53071",40895,2035,2715,8684,10830,5022,6714,4895,36145,11609,3.1760447120564,0.392479270772922
"53073",150367,3087,7139,32806,36028,16599,33686,21022,140141,54708,6.07176738190059,0.68766806243059
"53075",24106,293,828,3695,5220,2584,6050,5436,22985,11486,4.25789271754126,0.665942381631053
"53077",154958,23691,16970,42114,31549,12979,17492,10163,114297,27655,5.80542378551148,1.30733029040849
"54001",10656,387,912,5661,1620,688,821,567,9357,1388,1.50602641571734,0.0925104249180056
"54003",82695,2523,5421,30806,17605,6989,12782,6569,74751,19351,1.57936234279408,0.087195663400815
"54005",15704,732,1769,7418,2622,1396,929,838,13203,1767,2.59406296786389,0.133710434133497
"54007",9401,641,1046,4449,1464,501,867,433,7714,1300,1.74843452930273,0.138456348469994
"54009",16377,267,888,6836,3328,1696,2049,1313,15222,3362,0.793548174783708,0.0254086352931181
"54011",63341,2269,4530,20562,12702,5372,10306,7600,56542,17906,1.56488170171731,0.0769554697651043
"54013",4827,264,480,2571,849,170,367,126,4083,493,1.63799006010996,0.075456057004502
"54015",5614,523,596,2918,663,241,347,326,4495,673,1.35912673667382,0.0919066882515043
"54017",5942,282,699,2730,920,531,499,281,4961,780,1.51907279166924,0.0866615607344968
"54019",29514,1350,3260,12893,5246,1933,3518,1314,24904,4832,2.34032927702728,0.177618241416498
"54021",5176,215,602,2435,649,228,610,437,4359,1047,1.60232602379929,0.0914968728660022
"54023",8109,522,772,4200,1310,380,665,260,6815,925,2.08020414993748,0.129532268542946
"54025",24580,1266,1895,9877,4923,1955,2728,1936,21419,4664,2.96755635800509,0.27192983666679
"54027",17012,797,1394,8004,3292,1384,1358,783,14821,2141,1.95406247419783,0.174385738914324
"54029",21646,640,1536,8667,4479,2475,2466,1383,19470,3849,0.758799507718921,0.0242204607848562
"54031",10483,626,1026,4937,1682,833,724,655,8831,1379,2.10001699198823,0.157426515467681
"54033",47103,1213,4246,18346,8610,3710,6652,4326,41644,10978,1.69998620333509,0.112623325846498
"54035",20052,1020,1113,8669,3540,2244,2141,1325,17919,3466,1.78785130644665,0.126733321779301
"54037",39967,1176,2664,12335,8386,2957,7541,4908,36127,12449,1.30754302841846,0.0572296099870048
"54039",131715,3848,8954,48268,25248,9342,21528,14527,118913,36055,3.09211509860043,0.243109537097998
"54041",12204,476,1057,5799,2190,725,1261,696,10671,1957,1.67170333509353,0.104921004971497
"54043",14632,1028,1754,6754,2920,1042,787,347,11850,1134,2.37827563908048,0.116819857254498
"54045",23668,1247,3409,10690,4118,1547,1434,1223,19012,2657,2.35069641957688,0.120752695988002
"54049",38675,936,2487,15571,7120,3273,5708,3580,35252,9288,1.52983457491371,0.0844923362325021
"54051",22813,218,1455,9950,4382,2389,2622,1797,21140,4419,1.2771176696015,0.085084591870089
"54053",18581,1071,1431,8263,3089,1989,1954,784,16079,2738,1.75872172901015,0.11938537939544
"54047",14315,1271,2367,7257,2041,465,654,260,10677,914,2.07091455916328,0.140983169084475
"54055",42275,2235,3950,16456,8106,2757,5695,3076,36090,8771,1.49984415376571,0.110892170511628
"54057",19468,137,1120,9096,3208,1883,2265,1759,18211,4024,2.0666440962361,0.0891548906267906
"54059",16986,1599,2519,7736,2651,947,781,753,12868,1534,2.62905482529386,0.112169019715874
"54061",66375,1130,3323,16430,10121,4581,14411,16379,61922,30790,1.75710153691201,0.0994646762940511
"54063",9160,483,577,4808,1544,381,879,488,8100,1367,1.91517024981778,0.125091074242277
"54065",12938,329,1038,5662,2436,953,1243,1277,11571,2520,1.50815894378494,0.0623214391866396
"54067",18231,687,1360,8847,3343,1090,1493,1411,16184,2904,2.47121059060028,0.174538515262501
"54069",29854,442,1655,9841,5507,2475,5820,4114,27757,9934,0.713183997469584,0.0297885768578684
"54071",4698,333,465,2421,516,186,555,222,3900,777,2.00069602523605,0.187167511543605
"54073",5563,170,432,2683,1058,556,315,349,4961,664,1.11042206782339,0.0364287414896506
"54075",6114,351,718,2982,825,387,573,278,5045,851,2.70168145303535,0.251314239955606
"54077",25528,1177,2136,12281,4444,1214,2774,1502,22215,4276,1.7791401718602,0.17658492309193
"54079",40522,1210,1841,14775,8307,3582,6608,4199,37471,10807,1.43245621029829,0.0937467620469972
"54081",53489,1947,5256,21319,10775,3590,6590,4012,46286,10602,2.41133533169311,0.161398070701002
"54083",20588,874,1495,10530,3035,1101,2408,1145,18219,3553,3.31771130120827,0.279216049052495
"54085",6343,410,767,3147,933,474,393,219,5166,612,1.91548373188246,0.122477195830002
"54087",10220,621,1395,4671,1363,802,798,570,8204,1368,1.7408276907631,0.129762911993496
"54089",9475,571,910,3901,2050,411,965,667,7994,1632,1.57622967053979,0.0972530693501704
"54091",12318,302,1113,5396,2647,887,1232,741,10903,1973,0.985138173067709,0.0475303715415029
"54093",5390,192,469,2405,923,290,640,471,4729,1111,1.70410695611918,0.113585174396
"54095",6211,268,342,2931,1129,593,631,317,5601,948,1.60861633568902,0.0706802873295296
"54097",16397,788,1361,8299,2254,1030,1623,1042,14248,2665,1.48377353305598,0.0953984241920019
"54099",28281,1395,3774,10780,5269,2205,2729,2129,23112,4858,2.22106028077961,0.136318540145324
"54101",6093,650,645,2865,945,229,553,206,4798,759,1.66259914075244,0.148776019992004
"54103",10532,379,786,5081,1892,865,1085,444,9367,1529,1.77082789730241,0.0981467409771576
"54105",3874,258,445,1548,805,273,358,187,3171,545,1.38622348032824,0.0632421728805025
"54107",60499,1689,3950,21147,13472,7071,8248,4922,54860,13170,1.53115730570217,0.101802643761909
"54109",15690,1344,2197,7328,2149,847,992,833,12149,1825,2.19972053972997,0.132617148748999
"55001",16444,431,1566,6783,3769,1420,1864,611,14447,2475,2.11983281447319,0.199691553712997
"55003",11004,150,535,4142,2599,1481,1413,684,10319,2097,5.43049040518667,0.318890756106764
"55005",33059,1247,1886,11797,6526,4795,4622,2186,29926,6808,2.09033452645759,0.264933729870001
"55007",12314,127,436,3359,2669,1595,2598,1530,11751,4128,3.53008314039347,0.458913812510639
"55009",179330,5691,7978,52402,33600,22660,39866,17133,165661,56999,2.2795974601338,0.156641050199193
"55011",9713,171,649,3833,1775,1379,1377,529,8893,1906,2.23202140535364,0.207557142485674
"55013",12586,188,734,4783,2796,1382,1838,865,11664,2703,2.77488295403445,0.264176922827081
"55015",35997,616,1260,11389,6485,5363,7823,3061,34121,10884,1.42533377776089,0.115556985889002
"55017",46709,1040,2361,15730,9640,7014,7830,3094,43308,10924,2.35816166669751,0.308198399218998
"55019",21525,2348,1352,8521,4185,2325,2034,760,17825,2794,2.43397272444122,0.358554619959
"55021",41607,782,1717,13564,10476,5202,6709,3157,39108,9866,2.49466253512126,0.229269081484
"55023",11724,295,605,4745,2554,1455,1421,649,10824,2070,1.95892010619429,0.171988451157565
"55025",367947,5760,8679,64956,59532,33895,116324,78801,353508,195125,2.52664597248239,0.354223850305998
"55027",64588,1630,3545,26216,13372,7712,8640,3473,59413,12113,2.08958444747895,0.261123739055001
"55029",23080,277,763,6462,5441,2197,5192,2748,22040,7940,3.96925438676585,0.146506465572929
"55031",31592,418,1401,9191,7982,4203,5743,2654,29773,8397,2.76503666059781,0.40701642356058
"55033",27808,439,1226,9044,5628,3188,5396,2887,26143,8283,2.06063810936557,0.255125861553998
"55035",66906,1373,1624,17634,13640,10382,14756,7497,63909,22253,1.97647222987632,0.189785386976504
"55037",3591,76,222,1257,897,398,549,192,3293,741,2.04992599894771,0.149229953457958
"55039",72620,1638,4009,26132,14825,9337,11269,5410,66973,16679,2.23883955135513,0.221671732209998
"55041",6621,167,498,2605,1583,772,753,243,5956,996,2.6687776300204,0.312926881657024
"55043",32445,1193,1304,11023,6385,4799,4874,2867,29948,7741,2.57312005997326,0.337641769495398
"55045",26347,569,1320,9081,5523,3404,4359,2091,24458,6450,1.64910330280403,0.166301287360595
"55047",13382,405,851,5175,2845,1221,1913,972,12126,2885,1.49370840487636,0.110119224379496
"55049",16732,187,509,5775,3855,1968,2925,1513,16036,4438,2.02152251005445,0.219587291971498
"55051",4857,16,192,1594,1155,783,809,308,4649,1117,2.50527911682795,0.242587508422348
"55053",14875,495,916,6286,3125,1663,1566,824,13464,2390,2.77026445445311,0.292279052204504
"55055",59256,1724,2733,18834,13072,6591,11380,4922,54799,16302,1.648648879548,0.166681862339
"55057",19542,403,1485,7957,4455,2217,2120,905,17654,3025,2.57165547832515,0.233697724075502
"55059",114189,3955,5924,32250,26878,11759,21000,12423,104310,33423,1.36755179937914,0.0789754987691266
"55061",14628,268,620,5753,3083,2090,1998,816,13740,2814,1.35328689100211,0.100839154877785
"55063",77700,1276,2097,19758,16848,10387,16963,10371,74327,27334,1.72853241382123,0.13929412446175
"55065",11351,462,498,4581,2185,1421,1510,694,10391,2204,1.79154446455957,0.180489119443953
"55067",14259,327,1090,5855,3063,1648,1542,734,12842,2276,2.45153734187448,0.2635957854595
"55069",21172,472,1089,8768,4334,2540,2758,1211,19611,3969,2.10457956781965,0.269591701885508
"55071",58386,1429,2872,21097,12913,7241,9061,3773,54085,12834,1.79484749915705,0.173415925866742
"55073",95584,2908,3927,31571,18480,13228,17287,8183,88749,25470,3.0566418239942,0.465118615939492
"55075",31126,821,1842,11975,6863,4116,3870,1639,28463,5509,3.84017256619588,0.425166088005006
"55077",11580,225,756,5065,2734,1208,1160,432,10599,1592,1.61309310194246,0.134567125148002
"55078",2430,42,85,997,549,311,270,176,2303,446,1.51535319935405,0.107891645551007
"55079",623215,24408,43109,178071,124876,50761,128469,73521,555698,201990,1.1872043801159,0.0692710004883743
"55081",31074,1360,1521,11189,6884,3694,4374,2052,28193,6426,2.19036794293987,0.2637303377855
"55083",28466,455,1773,11812,5840,3732,3751,1103,26238,4854,3.15753649238,0.30035950106627
"55085",28668,371,1158,9079,6905,3473,4872,2810,27139,7682,2.93753577319189,0.37002637455999
"55087",128961,2388,4956,39515,25057,17457,27516,12072,121617,39588,1.78721209408586,0.188632891489504
"55089",63634,556,1122,13252,11574,5033,19646,12451,61956,32097,1.18727717512,0.0675991819099587
"55091",5289,157,247,1928,1100,659,863,335,4885,1198,1.76804182854941,0.0729912351239943
"55093",26651,266,1036,8272,5855,3389,5253,2580,25349,7833,1.8540894876916,0.174303720843068
"55095",32523,431,1573,11732,7033,4508,5085,2161,30519,7246,2.62614972179271,0.284942078367342
"55097",45562,832,1545,14425,7776,5750,10857,4377,43185,15234,2.11427560516976,0.241040848252503
"55099",10640,163,641,4375,2275,1468,1220,498,9836,1718,2.47379099822511,0.382223123450002
"55101",135096,3704,7490,41240,31742,14727,24075,12118,123902,36193,1.49981038318498,0.0969353915831409
"55103",12280,490,593,5011,2360,1358,1654,814,11197,2468,1.75671828489031,0.169503524938002
"55105",111685,2594,6303,38340,24104,13318,18320,8706,102788,27026,1.87697085240027,0.20651959458735
"55107",10348,333,773,4258,1939,1338,1177,530,9242,1707,2.41747052012433,0.277388104740508
"55111",45686,1162,2595,15128,9623,5810,8051,3317,41929,11368,2.33022027946113,0.244472963533999
"55113",13240,201,674,4526,3039,1461,2086,1253,12365,3339,2.78254962979667,0.405473941449998
"55115",29193,534,1663,12741,5560,3908,3323,1464,26996,4787,2.85355795321602,0.267805243823501
"55117",81841,1633,3327,27812,17721,9880,14455,7013,76881,21468,1.54771768753676,0.149740599157572
"55109",62700,521,1797,15958,12725,8568,16066,7065,60382,23131,2.04766937039549,0.217419547931869
"55119",13888,502,1032,6060,2683,1316,1590,705,12354,2295,2.46353024324771,0.292121925210502
"55121",20697,658,1054,7833,3736,3194,2878,1344,18985,4222,2.28606933826068,0.216712935788151
"55123",20589,1140,831,7636,3732,2409,3209,1632,18618,4841,2.52050604576434,0.235692929017192
"55125",17802,175,695,5697,4412,1765,3219,1839,16932,5058,2.91756682138705,0.306433759262107
"55127",70815,1579,4348,21520,15349,6574,14098,7347,64888,21445,1.64111509264503,0.163973568294444
"55129",12463,245,649,4278,2915,1511,2050,815,11569,2865,2.05325244109584,0.256220715604503
"55131",96531,1090,3720,28273,19566,11831,22095,9956,91721,32051,1.45309608398127,0.125287034048001
"55133",286664,3011,7317,59902,54921,27184,89588,44741,276336,134329,1.64638853695442,0.166046091554005
"55135",37590,669,1957,16189,6778,4382,5430,2185,34964,7615,2.10776322139232,0.224127868203998
"55137",18612,674,1374,7752,4003,1709,2095,1005,16564,3100,1.94618069245519,0.185630925005006
"55139",115862,2004,5384,37563,23400,13584,23838,10089,108474,33927,1.66379111038855,0.168314398676499
"55141",52814,1003,2512,20444,11025,7032,7085,3713,49299,10798,2.05633066175196,0.237029192400497
"56001",21286,272,607,3068,3777,1586,6054,5922,20407,11976,5.3802685316327,1.20630497932764
"56003",7904,247,644,2171,2283,992,1048,519,7013,1567,4.75054578601189,0.926071276269482
"56005",30235,851,1436,10613,7977,3154,3973,2231,27948,6204,4.93422073116178,1.40300598105445
"56007",10057,316,689,3795,2260,975,1580,442,9052,2022,6.62725140227531,2.23076397905479
"56009",9438,316,313,3302,2220,1191,1207,889,8809,2096,4.92722081871648,1.21865759477598
"56011",5030,49,313,1477,1294,676,1042,179,4668,1221,3.702218358107,0.841208548475606
"56013",26320,385,1641,8100,6701,2987,4008,2498,24294,6506,9.15144531278894,2.65118272716449
"56015",8919,194,418,2578,2488,1135,1335,771,8307,2106,3.2958948883114,0.629004119596187
"56017",3355,23,117,878,1080,427,578,252,3215,830,4.65540545548033,0.580229062075488
"56019",6041,59,220,1504,1570,513,1322,853,5762,2175,4.95603382707407,1.21384099025799
"56021",67817,1230,2848,16923,17318,9023,12748,7727,63739,20475,3.76312141489033,0.748414393625292
"56023",12919,135,704,4224,3194,1697,2029,936,12080,2965,5.56351526960697,1.15698308017497
"56025",54112,770,2485,15392,15303,6670,8510,4982,50857,13492,5.16158732993509,1.53671804649901
"56027",1929,48,103,661,544,168,329,76,1778,405,3.47249563162493,0.752281682269318
"56029",21379,261,730,5533,4595,3202,4704,2354,20388,7058,8.01370102437131,2.04204824451202
"56031",6601,86,461,2426,1567,585,703,773,6054,1476,3.17813708505709,0.595334265366491
"56033",21696,271,639,6246,5708,2054,3908,2870,20786,6778,4.7276973546607,0.744156552380724
"56035",6101,25,278,1969,1656,550,1278,345,5798,1623,5.6379487112575,1.405676115072
"56037",27816,678,1351,9069,7280,4044,3452,1942,25787,5394,7.66004822831529,2.93721267254442
"56039",17659,280,421,2984,3164,591,6758,3461,16958,10219,5.08110531031775,1.22444810858481
"56041",13233,394,457,4820,3612,1574,1630,746,12382,2376,3.15855132366217,0.581244783274953
"56043",5423,59,261,1391,1601,692,935,484,5103,1419,4.24672093505951,0.650695341386017
"56045",4892,100,248,1826,1154,664,678,222,4544,900,3.40716036957672,0.695232084633677
"60010",NA,NA,NA,NA,NA,NA,NA,NA,NA,NA,0.835444951401149,0.00552539028627092
"60020",NA,NA,NA,NA,NA,NA,NA,NA,NA,NA,0.546698323883595,0.00491929598522654
"60030",NA,NA,NA,NA,NA,NA,NA,NA,NA,NA,0.0152913564742715,8.33487049993898e-06
"60040",NA,NA,NA,NA,NA,NA,NA,NA,NA,NA,0.0648699611448109,0.00029969559249968
"60050",NA,NA,NA,NA,NA,NA,NA,NA,NA,NA,0.446050429463859,0.00616395123795962
"66010",NA,NA,NA,NA,NA,NA,NA,NA,NA,NA,1.40989027369593,0.0466939085869051
"69085",NA,NA,NA,NA,NA,NA,NA,NA,NA,NA,1.49098559865346,0.0136774622583101
"69100",NA,NA,NA,NA,NA,NA,NA,NA,NA,NA,0.464730853903717,0.00714107735704045
"69110",NA,NA,NA,NA,NA,NA,NA,NA,NA,NA,0.679440375227015,0.010002234483695
"69120",NA,NA,NA,NA,NA,NA,NA,NA,NA,NA,0.592647888318872,0.00919044532591689
"72001",13018,3233,1307,3881,1157,1565,1592,283,8478,1875,0.620696208776124,0.0148378593310008
"72003",28428,6721,2815,7340,2198,3117,4757,1480,18892,6237,0.422688748869865,0.00689839843641295
"72005",40042,6046,3912,11862,5137,3251,6964,2870,30084,9834,0.434739050900437,0.00812280445855836
"72007",17784,2848,1762,6034,1895,1853,2818,574,13174,3392,0.433580388425225,0.00665645521999981
"72009",18117,2465,1309,6637,2214,1385,2714,1393,14343,4107,0.402367973278584,0.00692380253999998
"72011",19098,3746,1760,5968,1600,2464,2742,818,13592,3560,0.535544449061691,0.00877715616630134
"72013",64361,9303,4880,19371,8568,6157,12457,3625,50178,16082,0.790758557635909,0.0281502875377946
"72015",11446,1447,1234,3554,1479,1370,1930,432,8765,2362,0.27014750143122,0.003328801455622
"72017",16419,2731,1467,5083,1406,1661,3250,821,12221,4071,0.408551650508277,0.0041877887892617
"72019",19880,2940,1984,5666,2908,2027,3372,983,14956,4355,0.508414011440457,0.00758838429550123
"72021",136733,14795,9191,31854,24924,15010,30116,10843,112747,40959,0.563901148068346,0.00986684866649947
"72023",35160,6072,3116,8904,4247,3638,7045,2138,25972,9183,0.792049515373017,0.0163585608209233
"72025",93391,9397,6019,25339,12257,9238,21925,9216,77975,31141,0.613725482599286,0.0130694108805001
"72027",24097,4355,2254,6016,1979,4337,3604,1552,17488,5156,0.454823525198127,0.0103033213277696
"72029",30565,4315,2490,8733,3206,3746,5421,2654,23760,8075,0.587243080690898,0.00730205100800068
"72031",114495,9188,5661,30012,15690,15425,28146,10373,99646,38519,0.684664001681719,0.01059846351791
"72033",16870,2337,1567,5721,1838,1916,2502,989,12966,3491,0.181955603311579,0.00110477884623562
"72035",30858,5007,1930,9928,3428,2405,5861,2299,23921,8160,0.683101120185517,0.0114887252019999
"72037",8438,1477,617,2934,874,758,1451,327,6344,1778,0.745014242441351,0.00661912339520617
"72039",12399,2602,1478,3599,1701,1105,1520,394,8319,1914,0.814381256231264,0.0147593078554987
"72041",28848,4893,1540,9378,3060,2966,4995,2016,22415,7011,0.572685683350258,0.0080649864280005
"72043",25865,3386,1597,10081,2642,2217,4586,1356,20882,5942,0.698894800467962,0.0172548695930003
"72045",13618,2570,1211,3864,2345,1582,1558,488,9837,2046,0.391301580119969,0.0063083040319988
"72047",24558,4227,2531,7022,3088,2432,4136,1122,17800,5258,0.422671539773817,0.00942271296499892
"72049",940,113,60,332,143,127,153,12,767,165,0.477897886692537,0.00328509543800406
"72051",25509,2766,1771,7057,3516,2421,5326,2652,20972,7978,0.454860674408022,0.00521295457530898
"72053",23310,2515,1432,7870,2717,2033,5321,1422,19363,6743,0.610840743644403,0.00688260211829529
"72054",8137,1206,549,2789,1178,879,1223,313,6382,1536,0.258430155894658,0.00336988438849973
"72055",10351,1794,1288,3867,711,1130,1226,335,7269,1561,0.435272706637133,0.00851598488014223
"72057",26525,3351,2325,10365,2660,2229,3995,1600,20849,5595,0.755528163352424,0.0154074010853135
"72059",12883,1878,1077,3840,964,1999,2344,781,9928,3125,0.628247154663186,0.0096861528211708
"72061",68437,6362,3397,12173,8326,6563,20616,11000,58678,31616,0.551124207557195,0.0061152578517293
"72063",29547,3394,2006,7201,3867,3480,6438,3161,24147,9599,0.435005477696263,0.00626528428000022
"72065",28662,4841,1926,6947,1560,5086,6038,2264,21895,8302,0.503580496908586,0.00927655911875761
"72067",11965,1739,714,4073,1321,1031,2376,711,9512,3087,0.292317388147411,0.00250439260249988
"72069",37763,4588,3347,13522,3684,4061,5936,2625,29828,8561,0.521717903703328,0.00995749326383062
"72071",31652,5872,2382,9249,2871,3482,5816,1980,23398,7796,0.618537109566138,0.0123046370903361
"72073",10377,1557,573,3787,1649,644,1607,560,8247,2167,0.607929834393847,0.00985491274099977
"72075",32836,4549,2856,10002,2726,3773,6888,2042,25431,8930,0.707911169323846,0.0133779243670414
"72077",26251,4204,2117,7087,4065,3160,4381,1237,19930,5618,0.428748091911992,0.0058923732834992
"72079",16972,3622,1969,4795,1682,2105,2284,515,11381,2799,0.562159414643936,0.013580777985297
"72081",20656,4864,1940,4863,2047,2604,3256,1082,13852,4338,0.604479941021433,0.0136393481854992
"72083",6187,1638,625,2106,191,509,945,173,3924,1118,0.619829886608464,0.0102906334955016
"72085",25646,3655,1401,6060,4719,3376,4629,1806,20590,6435,0.480628376380776,0.00749508477599936
"72087",17262,2250,1898,6629,1291,2258,2474,462,13114,2936,0.469833429020351,0.00466640238117068
"72089",12968,1864,974,4300,1429,1557,2088,756,10130,2844,0.390591466728673,0.0056900677386343
"72091",28686,4410,2643,8656,3518,2699,5210,1550,21633,6760,0.549338760260384,0.0102520465839998
"72093",3988,1234,408,1257,464,189,313,123,2346,436,0.561894343582191,0.00810065885299953
"72095",7952,1389,708,2448,1078,1110,980,239,5855,1219,0.397188790274769,0.00467397662350029
"72097",50368,9281,4696,13317,5548,3340,9563,4623,36391,14186,0.964512207584134,0.0171273155277305
"72099",26709,5328,2634,8171,2595,1927,4483,1571,18747,6054,0.490806089381067,0.0111490455265017
"72101",20508,3436,1917,6276,2628,2659,2896,696,15155,3592,0.431938850146231,0.00861937176950068
"72103",16546,2767,1070,6317,1024,1716,2878,774,12709,3652,0.597198021290566,0.0114368062332157
"72105",20993,3777,2253,5075,3684,2438,3162,604,14963,3766,0.396758632393605,0.00614128875299915
"72107",15163,2847,1674,4706,1678,1553,2011,694,10642,2705,0.725386414681551,0.0141079455845004
"72109",12052,1836,869,3575,1934,1474,1583,781,9347,2364,0.591474876687753,0.0104010768801038
"72111",14252,2354,1323,3956,1036,2036,3079,468,10575,3547,0.618336415424657,0.00990905319199583
"72113",99337,13831,7906,30655,9281,8654,20364,8646,77600,29010,0.865177349294681,0.0258505162774585
"72115",17284,2786,1616,5174,1534,2462,2683,1029,12882,3712,0.393516568981141,0.00513364766181901
"72117",11567,2214,893,3005,1087,1722,2004,642,8460,2646,0.288172499504601,0.00317440506735083
"72119",34734,4392,3330,10116,4140,4175,6930,1651,27012,8581,0.599976189840151,0.0135062907203028
"72121",15604,2632,1220,5303,1446,1597,2656,750,11752,3406,0.457154968613669,0.00803794826100013
"72123",18459,2642,1639,7468,1664,1453,2801,792,14178,3593,0.660722664408659,0.0163486981886144
"72125",23079,4276,2425,7842,1741,1731,3653,1411,16378,5064,0.565180957687369,0.0120501102955003
"72127",253731,27306,14379,55109,26912,28603,60451,40971,212046,101422,0.679935207334716,0.0109946416655449
"72129",27675,5075,2587,6983,4520,3368,3611,1531,20013,5142,0.564142725170203,0.0117718000045002
"72131",28941,6214,2618,7618,3077,3408,4688,1318,20109,6006,0.672091308839268,0.0157628121859995
"72133",14294,1708,597,5515,1404,1246,2888,936,11989,3824,0.401675239430711,0.00771046723588674
"72135",47853,5175,2746,12588,5611,8847,9784,3102,39932,12886,0.400663044126439,0.00610377970050224
"72137",55064,6308,3686,14398,8525,6926,11664,3557,45070,15221,0.468669173674381,0.00519344055158285
"72139",49339,4739,2456,11237,6722,5956,13202,5027,42144,18229,0.363046826236812,0.00473418005550006
"72141",20883,3918,1608,5504,3560,1891,3589,813,15357,4402,1.04802459193228,0.0254648359469997
"72143",25251,3999,2214,7350,2858,3270,3756,1804,19038,5560,0.442611578111395,0.00615478669470606
"72145",39632,6041,3425,11932,4583,4663,6627,2361,30166,8988,0.480032309223851,0.0103312713893144
"72147",5970,887,726,2872,95,545,424,421,4357,845,0.767737898310935,0.0122243170845423
"72149",15523,2462,867,5469,1628,1764,2658,675,12194,3333,0.416063645065183,0.00819303083999959
"72151",22690,3667,2430,6011,3947,2684,3353,598,16593,3951,0.655519204893296,0.012276697154178
"72153",25661,3751,1933,8894,2330,2102,5090,1561,19977,6651,0.695732530465162,0.0150869190905325
"78010",NA,NA,NA,NA,NA,NA,NA,NA,NA,NA,1.02219051850454,0.0183978906443912
"78020",NA,NA,NA,NA,NA,NA,NA,NA,NA,NA,0.859249301796831,0.00435594381833483
"78030",NA,NA,NA,NA,NA,NA,NA,NA,NA,NA,1.36320663950329,0.00683853027812504
